;Map made by Santella Agustin
;element index
;  D : Diert
;  M : Mountain
;  W : Water

; starting the level:
XYXMYYYMYXXYXYYXYMMMYYYXMXXYXYMMMMYXYXXYYYXXXYYXYYXXMYXYXMYXXXXXXXMXXM
MYMXYYMXYXXMXXYYXYXYYYXXYMXXMMXMXYXMMYYMXMXXXMMYYMYXXYXYYYXMYMXXMXXXMY
MXYYYYYMMXXMMYYYXYYXYMXXYYYYYMYYYXMMMYYYYMXMMMYXMXXYMXXYMYMXXMMXMMXXYM
YMXXXMYXMXXXXMYYYMXYXMYXMYXXXXYXXXMXYYXYXXYYMYMMMXYMMMMMXMXMXXXMMYMYXM
YMYMMXYMYYMMYMMYMYYYYXMXYYYMXXXXMYYMYYXXXYMYMXXMXXYMMYYMXMYMYYYMYMXXMM
MXXXYMYMXMMMXXXMMYYYYMMYYMYXYMXXXXYMMYXYYYYXMYXYYMXYMYXMXMYXXMMMXXYXYY
MXXYMXYMYXXYXMXMMXMXXMYXMMYYXXYXMYMYYMMYMXMXXMXMYYMMYMYYXMYMMYYMMXMXYX
XMMXYYXMMMXYYXXXMXXYYXYMYMMXXXYMMMYMXMYYXXXMXXMXXMYXYYXMYXXYMYYXYXMYYX
YXYXYMYYXYMMMYYMYMMXMYXXYXYYYXXYMYMMXXMXYYMXMXXXYYYMXYXXMMYYMXYXMYXXMM
XYMXXYYMXXMXMXYMYYMYMYXYMXMMYYMYXYYMXMYYXYMMXMYYYMMYXMYXMYXXXMMMMYMMMY
XXMYMMMYMYYYXMMMXMXMXYXYYXMMMMYYYMMXYYMYYMYMMXYYXXYMMXXYYYYMYXXMYXMYXY
MXXMXYYYYXXXYXMYYYMYMYXYMXMMXXYYYYXXMYYYMYYMMXMYMXMXXXYXMMXMYXYYYMMXYX
MYMYMYXMXMYXXXYXMXXXYXMMMXMMXMMYMXXMMXXXYMYXYXXMYXXMYXYYXXMMMYXYMYMMYM
MYMXMYYXMYMYXYXMYMMMXMYMMMYXXXYXXXMMMMMXYXYYXXXXXMYYMMXYYYXYMYMYYXXMYM
MXXXYYMMXYMXMYMYMMXMYXYMMYYYMMYXMMMMXXYMMMXXMMMMMYXMMYXYXMMYXXMYXMYYYY
MXMMYYXMMMMXYYXMXXXXMXMXXXYYMXXYMYMXMXMMMXYMYXXYYXYYXXXXXXXXYYXYYMYMMX
MYXXYMYYYMMMYXXMMMMMYXXYMMMXYMMMYXYMXYXYYXYXYXXYXYXXXXXXYXMMMYYXYMXYMX
YYXXXYMYMMXYMYXMYMMYYXYMMMXXXXYXMXMXMXXYYXMMYXYYYMYXYMYXYMYYXYMXYYMYXM
YYMYXXYXXMXYXYXXYMXXXYYYXYXYXXMYYXMXYYMMXMXYMMYMYMMXXXYMMYYYYXXYXYXMXM
MXXMXXMXMMXMYXMMMMYXXYXMMMYXXYXMMMMMYMYXMMYYMYMMXYXMYMYXMYXXYYMYMYXYXY
MXXMMYYYXMXMXYMXMYXXMYYMXYYYXXMXXYYXMMMXMYYMXYYXXYMXYMXXXYYYYXYMMXXYMM
MXMYYYMMMMYXXXYXMXYMYMXYXYMXMMYMXMYMMMYMYMMYXYYXMYXMXMMXMMYMMXMMMXYMMM
MXYYXYYYYXYMMMMXMYYXXYMMXYYMYXYXYMYYYXMMYXXMXYXMMXYXMYMMMXXMYYYYMYYXMM
MMYXXMXXYYYXMMYXMMMYMMYYYMXMMXYXMXXYYMXXYXXMMMMXYXMXXXYXXMXXMYYYYYXMXY
MXYXYMYYMYYMMXMXYMMMYMXYYMMXMYYXMMYXMXYXYMMMXMMYYXMMXYMYXYXMXMYYYYXXXY
XXMMXYXMYXYYMYYXYYXMMMXMXYXMXXYYMMYXMXXYXYYYYMYXMMMYYXYMYYYMMYMXMMXYXX
XYYYMMXYXYYXMXXXXYYXMXXYMXMMXMXXYYYMYXXMXXMMMMMMYXMYYMXMYYYMMMMMYYXYYY
XMXXXYXMXXMXMXXMMYYXMXXXYXYYMYXMXMXYXYYMMYYXYYMXMYYYMYMXMMXYXXMXYXMMYM
MMXXYMXYMXXYYYYXYMMYXXXXXXYMXXXYMMMYMMMMYYXMYYYMMYXXMXYYYMYYMYMMXYMMXM
XMXMXXYYMMYXMMYMYMMMMYXYMXXXMXXXXXYMYXYXXXXYMXMMMMYXYYYXXMXMXXXXYXMYXY
XYMYXXMYXXYYMMXXYYMYXXXMXYMXXMYMXYXYMYYXYMXXXMMXYXXMXYMMMMMMXXYMMYXYMM
YXMXYXYYXMXXYYMMYMYXMXXMYXYMMXMMXMXMMMXXMYYYYMYMXXYMYMYYYMXXXMXYYYXYMY
XXMYXYXMYMYMXYYXMMMMXMYYMYYYXMMYXYMXMMYMYMMMXXXMMXMYMXMMXMYMMXXXXYMYXY
MYXXXYYYMYMXYXMMYYMYXMXXXYYMXMXMYXXXYMYXMXYYMYYXMMXXYXXYYXXMMXYYMYMXXX
XXMMXMXYYMMMYYXMXMMXXXMMXYMYYXXXMYYYYXMMMMYYXXYMXMYMXXXMMYYMXXYXXMYMYY
XXXXYMYMMMYYYMMYYXXMMXMYXMMYXYXYYMMYMYYYYXMYYXXMMYYMMMMXYYMXYMMXXMXMYM
MMXMMXYXXMYMMMYMMMMMYYYMYYXYXYXXYXXYMYYXYMMMMYMXMMYYMYYYYMXMYXXXXXYMXY
MYYMYYMYMMXXXXXMYXYMXYXXYYXYYXYYXMMXYYYXYMXXXYYMXMMXMYYXYXYYMMMYXXXXXY
YXXMMXXMXMXYXYXYYMMMXMYYYYMMXYXXMYMXYYMMMMXXMXYYXYXXYYXXMXXMXYMXMYMMMM
MXMMXYYXYMYMYXMMXXMYMMXYYXXYYXYMMMMMMYXMXXMMMYMYMMXMXXMMYXMMMMMXXXMMXX
MYMXMMYMYYMXMXMXYMXYMMMYMXMXYYXMMXYMXXXXXYXYYXYYXYMYYMMMYMMXMXYXXMYMMY
MXMYXYXXXMMXXYMMYMYXXMYXMMYYMYMYXXXMXYYXXYYMYMXXXYMXMXXMXXMYMMMXXXYXYY
YMMMYYXXXXYYXMYMYXMXXYXMMXMMMXMMMMXMXXXMMXYMXYXXYYYMYMMXXXXXXMYMMMYMMX
YXMXYMMYYYXMYYXMMXXYXMMXMYMMYMMYMMMYYMYMXYYXMYXXMMXXYMYXMXXXXXMMXXYYYY
YMMYMYXXYXXYMMXYYYXMYYXYMXMYYXMXXXMMMXMMYMXXYMXMYMYYYMMMMMYXMMMXMMXYXY
YMMXMMMXXXXXXMYMXMYYYXMMMXYYXXYYXXXXXYMMXXXYYXMXMXYYXMXYYYXYYXXXYXYXXM
YYMXYMMMYXXYMMXMXMYYXMYMYMXXXMYMMYYXXXXYMXYXYYYXYYXXXMMXMMMYYYYMXYYXMY
XXYMYXYXMYMMYXYMMYMYMXMMYXXMMXYXYXMXYYMXMYXMYXYXMXMMYMYMYXXYXXMMXMMYYX
XYXXMXXMMYMYXMYYXXYMXXMXMMYXYXYYXXXYXYYMXMXXXYXMXYMYYYMXXYMMYXMXYXMXYY
MMXYMMMXYMYMYMXYXXYMMYXMXXMYXXYYMXYXXYYXMYYMMYMMXMYYXYYYYYXYXMYYYMMXXY
MYMMYMYMXMYMYXXYMYXMXYYYXXYYMYYYYMYMYYYYYMYYMMYXXXYXXMXXYYYYYXYMXXYMXX
YYYMYMMYMMYMYYMYMYMMXMYMXXYXYXXXYMMMMXMXYXMYMXYYYMXXMMYMYXXMXXMXMXMYMM
XXMXXYYXXMYMXYYMXXMYXMMYMXXXXXMXMXMXYYXXXXYMMYMXMMYMXXMMYXYMXXYYYYMYMY
YYYYMXXXMYMMYMXMXXYYXMMXXXYMMMMMMXMXMMXMXMMYMXMMMMMYMXXMXXMXMXXYMYYYXY
MYXMMMXMXMXXXMMXMMXYXXMYXMYMYYMXMYMYXXMYMMXYXXYMYMXYXYYXMYXXMXXYXMMYYX
YMMXXYXYXXYMXXXMMMXXYXMMXYXMYXXMYMXYYMYXMYXXYYMXMMMMMYXXYXYMMYMYYMYYYY
MYXXMMMYXXXXXXYYYYYXMXMMMYMYMYYMMMMYYMXXMXYXMYYXYYMYMYMMYXMXYMMXXXYXXY
YXMXYMYYXMYYXYMMMXYXXYYYMMXYXXYYYXXXYYXYMMYXMYMMXMMMYXXYXYYYMYMMMYMXXY
YMYMMXYXYMYMXMMMMYMMXMXXYXYXYMXMXMMXMMMMYMXMYXMYYXYXMYMYYXMXMYMYYYMXYM
MYYMMYMXXXYMMXXMXMYYXMMMMYMYYMMXYMYYXXXXMMXYMXMXXYMYYXXXXYXMYXYXXYXMXM
MMYMMYXXYYMXXMMXXXMYYYXMMMMXMMMXXXMYXMMYXXMXMYXYMYYXXXMMMMYXXMYYMXMYMM
MMXYXYYXXMXXXXXYYXXYXXMMYXXXYXMMYMYMYYYMYXYYYYMXMXYMXYMXYYYMYMXYYXYMXX
YMXMMYYXXXYXXYXYMMMMYYXMMXXMYMYYMMXMMYYXXXXYMMYYYYXMYXYMXXYYMYMMXXYMMX
MXMYMXXYMXYYXYYYMMXMXMYXXMYMYYXMMYXXMYXMXYMXMMXYXXYMXXMXYMYMMXYMXYYXXX
YXYXYXXYYMYMXMXYMYMMMYMXXXYMXXMMYYXMMYXXXXYXMYYYMMYYYMYMXXXXYMMXMXMYXM
MXMXMXMMYMYMYMMMMXXXYYYYMMYYMMYYMXXXXXMMMYXXMMMMYYYMXXYXMYMXYYYMXXXMYM
YXXMMXMXMXYYYXYMMMXXXXMMMMXXYMYMXMMXYYXYXMMXXYXMYMMYXXYXXXXMYYXYYMMXMX
MXYYYXMMMYYMXMYYYYYMMXMYYMXYYXMXXMYYYMXMYMXXYXXXMMXXXYYMMMXXXXXMMYYXXY
MXMMMMMMXYYMYMMYYYYMYXMXYMMMXYXMXXMXXMMYMYMYMMYYXXYMMMMXYYMXYMXXYYMYXX
MYXXMYMMYYMYMMXMXXYMYXXMYMYYMYXXYXXMMYXXXYYMYYMXMMXMMXXMXYMMMXMYMYYXXX
XYYXXYXMMMXMYXYMMMYYYYMYMYMXXMYMYMXYXMXYXMMMYMXYMXYMMMXMXMXYXXXXMXYMMY
YXMXXMMMMYMYMXMYYXXXYXYXYMXYYMYXXYXXYXXYMXYXXXMMYYXMXXYXMYYXYXMMMXMXXY
XYXMMYXMXMYYXYYMXXYYXYXYMMXXXYYXXYXYXMMYYXMYYMMYMYXMMXMXYMYYYYXXYXXYXX
MMYYMYYYMXXYXMXXXMYXXXMMYMMMXXXXMMYMXYYYMMXXXXYYYXYMYXYXYYYYXYMMYYMXYM
XYMMMMXYMXMMXYXYMMYXXMXYMMXXMMMMMMXYXYXMMYMYYYMXYYMYXMYMXXYMMYMXYMXMMX
YXYYYMXYMXYMYYMMYMYXYMXXYYMXMXMMMYXMXXXXYXYMYYYXXMYYXMYMYXXMYYYMMMXMXM
YXXXMYYYMXXMXMXMYXXMYXXMYYYYYYYYMXYXMMXMMXMXXYYMYXMMXXXYMMYXXMXXXXXXMX
MYYMXXXMYYMYXYXMMMMYYMYYYMYXMXXXXXMXYXMMYYMMYMMXYYMXMMXXXMMYXYYMXXMXMM
XMXMXXMYMXMXMMMXYXYXXYXMXXXXXXMMYMYXXMMXYMXMXMMXXMXMXMYYXYMYMYXXXYMXYY
MXMYXMYYMYXXXXYYMXXMYXXMMYYXMMYMMXXMMMYYMYXXXXXXYXMYYYXXYYMXMYXXXXYMXX
XYYXMXXYMYMMYYYMMMYYMYMYXMXYYXXXMMMXXYMXMYXMXMYMMXYMMXMMXYXXXMMYYMXYYY
XXXMMMMMMMMYMMMXXYMYMYYXMMXMXMYYYMYMYYYYYYMMYYXYXYYXMXXMMXYMYXXMMMXXMM
YMXMMYYXYXXYXYMXXMYXXMMXYMMYXYYXXXYYYXXXYYMYYYXYXYXMXMXMYMYMMYMMXXMMXX
YXYMYMYYMXYYXMMYYMMYMYMMMMMYYYYMMXXYMXMXYYXXYMXMYMXXYXYMYXYMXXYXXXYXYX
YYMMYMXXMMXMMMYYYMXXYXXMXYMMMMMMXYMMYYXYYYXYXMYYMXMXXMMXYXMYXXYXYXMYYM
YYXXMXMYMXMMYXXMXXYMYYMXXYYXXMYMYYMYXXYMXYMYXXMMXXYMYMMXYYMMXMMYXXMXMX
YXMMYYMXXXMXYYXMXMXMMYXYXMYMYXXXXMYYXXXXMMXXXYYMYYXMXXYYYMXYYYXYXXMMMX
YMMXYMMYMXYXYXMMYXYXXMMXXYYYYYMYMYMXMMMMMMMXXXMYYMMMXMXXYMXMMMMMMXMMMY
YXYMYXYYXMMYMMMMXYXXXMXYMXYMYXXMYYMMXXYXMYYXXMXYMXXMXMXXMXXXXXXMYXXMYY
YMYMMXMXXYYXXMMYXMYMXMXYYYYXXXXYMXMYMXMYMXMMMYYMMXYYXXYYYXYYMXYYXYXYYX
XXMYYMMMXYXXYXYXXMXYYMXYYYXMYXXYMMMXYMXXYYYYMYXMXXXXYXYXYMYMYXMXXMXMXY
MYXYYXXMYMMXMMYYXYXMXYXXMXYMYXYMXXMYYMXMMXXXMXYXMYMMXYYXMMXMYYYYMXXMMM
XYXMYYMMYXYXXYXXYMMXYXXYYXXXXXXXMMXYYMYYYXXXMXXXXYXMMXYMXMYXYXYMXXMYMY
YYXMMYYXMYYMXYYMYMMYYMMMXMMXMMXYMMMYXXXYYYMMYMMMXYYMYMMYXXMYMMMXXYXXYY
MMMYYMMYMYMMMYXMXYMYYYYMMYXMYXMYXXXXXMXYYYXYYYXMXXYMXYMXXYXYXYXMMYYXMX
MXXYMMYXXYYYXXXYYMXXYYYXYXMXMYYYYMYMMXXXMMYYXMMXXMXYMYYYMMMYYYXMXMXYMM
YXXMMYMMXXXYXXMXYMYMMXMYYXXMMXXYMMMYYMXMYXYXMMYYXMXMYYXYXMXMMYXXMYXYMX
XMYMMYYXMMYYMYXXYYYMMMYYXMMXMXXMXYMYMXYMMYMXMMXXXXXMXXYXXXYYXMXXYYMYXY
MMXXXYXXMMMXXMMMXYMYMMXYMYYXYXMMYXYYYMMMXMXYYMMXXYMMMMXMXMYXYMMMXYMXYM
MYXXXMMXYMXYYMMYXYMMYXXYYYMYXMXXYMYMXMXYMMYYMXMYXXXXXMMMMYXMXMYMXYYXXX
YMYYMMYXYXXYYYXYXXXMYYYXXYYXMMMMYXMXMXYMYXXYXYXYYYXXMXYMXYXYMYXXYXYYYX
XMMXMXYYYYMXYXXMYMXXYXYYXXYYYMMXXXYXXYXMYMMXXYYXXXYXXYMYMXYXMXXXXMXYMM
MYXXYXXYXMXMYYYXXYMMMMMMXXMXYXYMXXXXYXYMMYXYMYMYXMMYXYYYMYMMXMYYYXYYYY
YXXYYMYMXXMYMXXMXXXMYYMYXXYYXMMYMMYMMYMXXXMYMXXYYXYMXXXMMXXMMYXYXYYMMM
MXXXMYMXYXMXMXYMYMXMMXYXMMYXXYYYMXMYMYXXXMMYXMXYMMXMYYYYYMMYYMYYMXXYYX
XYYXMYYYMYXMMMMYYMMXYXMXYXYYMMMXYXYMMYYXXYXYYMMMXYYMMYMYXMYMXMMYMMYYMM
YYMMYYXXMMMXYMMMYYMXMXYXXXYYMYYYMYXMYYYYYYXYMYXYYYXYXXMXMMYYYXYYXMYMYX
MMYYYMYYXMYYMMXMXYMXMXMXXYXXYXYYYXMMYMXXXMYYXMMMMXXYYMXYMMMMXXMXXYMXYX
XXXYXYMYMXYXXXXXXXXXXYYXXXMMYYXXXXMYMMXMMXXYMMMYYYMXMYMMYMXMMXYXMXMMXX
MXYXMMYMMMMMMYMXMMXMYYYMMMMXYYYMYXMXMYYYXMMXYXXXMYXXMMXMYXYXXMYMMXMXMY
MMYXXYYYMYMXXYYYXYMXYYXMMMYMXXXYXMXMXXXMMMMYMXXXYYXMMMXYXYMXMXXMXYMMXY
YYMYYXXYYXYYMXYMMMMYXMXMYXMXYYMXXXXMXYMMYYYXMXXMMYYXYXMMXYMYMMMYXMYYMM
MMMXXYYYMYMYYMXMMYMYXYMYXXYYMXYMMMMXXYYYYYXMXXYMXMYYXMYMYMXMYYYYMMXYXM
XMXXYMMYXYMYXXYMMMYXYXMMYMMYMMYYYXYMXMXMXXYMXYMYYMYXYXMYYXXMXYXMXXXYXM
MXMXYXYMMYXXYXXYMYMYXMXMYMXMMYYMYMXXYXYXMMMMYMYXYMMYXMYXYMMYYMXXYXYXYX
XXYYXMMXXMXXMXYXYYYYYYYYMMXXXYMYMMXMYXXMXYYYYMXXXMYMXMXMMMXYYYYMXXMXXY
XXMYMMXYMYYXXYMMMXMXYMYXMXXXMXXMYMYXXYXXMMXXMYXMXXMMMMMMMYXYXXYXMYMMXM
YYYMMMXXXMYYYYYXXXYXYYMMYMMXYXMXMXMXYMYMMMXYMXYMMYMXMYMMYYMYXXYMMXMXMM
XMYMYXYYXMYXYYXXXMMXYXXYXMMYYMMXYXXMMYMXMYMYYXYYYMXYXXYYXMYMMMMXXYYYXY
XYXYXXYXYXYYXMXXMXMXXYMYXMXXXYXMMXYYXMYYYXYMYYMXXYYXMMXXXMYXXYMYXMYYXM