;Map made by Santella Agustin
;element index
;  D : Diert
;  M : Mountain
;  W : Water

; starting the level:
YYXYYMYXMXXMMXYMMXXXMXYYXMYMMXXYMYYYXYMYYYMYXMYYXXMXYXMMMMXYMYMYMYXMYX
XXYYYXXXYMYYXYMYYMYMXXMXXMXYXYXMYXMXMMYYMXMXYMXYYYMYXYXYYMMXXMMXXMXMMM
YXMXYYXYXXXYXMXMMYYMYXYYXYMMXXXXYXMXMMXMXXYYYXYXYXXYMMMYYMXMMMMYXXYMXX
XYXXXXMMMMXYXYXYYYMXMMYYXYMXMYMXMYYXXYYXMYYXMXXXXYMYYMXYXXXYXMYYXMMMMM
YXXXYXMYMXYYMMMXXXMXYMXYXXXXYYYXXXXMXMXYMYMYMYMXYMXYMXXXXYXYXMYYMXMMMX
YMYMYMYXXXMXMXYYXYMMMXMYMYMXYYYXXYXXMMYYXMMXXMXMYMYMMYYMYMXXXXMXYXYXXM
YMYMYYMMYYMMYMXMMXMMYXYXYYXYMXMYMMYXXXYMXXXXMYYYYYMYMMMMXYYYYMYXXYYMMM
XYMXXXYMMYMMYYYXYYMYMXYMMYMYYMMMYYMXXXMXXMYXXMYYXXXMMMYMMMYMYXYYMXYXMY
XXYMYXMMXMYYXYYXMXXXXYXMYMXMMMMYMYMXXXXMYMMYMYMMXYMMXYXMYYXYYYYMYXMXYY
MXYXMYXXMXYYXMMYYXYXMXMYXXMYXMYXMYYMXMYMMXXMYMYXXMYMXXMMMMMMMMXXMMMXXY
YYYYMMMMYMXXYYMYXYXXYMYXYYXMMYMXMMMMXXYYYXMXXMXXMYYMYMXMYXXMMMMXMXXMYX
XXYYYYMMYYYMYMXXYMMYYYXXXYYMXMYYMMMMXYXXMYMYMXMXYXXYYYXYMYYYYYXYMMMXMM
XXXMMXMXMYXXMXXYYMXMMMMMMYXYMMYMMYYXXYYYXMMXXXXMMYXYXXYMXMYXMYYXMYYYYM
MMMYYMYYXMXMMMMXXYXMYYYXXXXMMXXXXXXMXMYMMMMXYXXYMMYXYMMYXYXMMMMMMXYXMX
YMYXYMXYXMMXYMMYXYYMMYYYXXYYMXXYXXYYXYMYMYYXXXXXMYXMMYYXXMXMMYYMXXXMXX
YYXYMXYYYXXMYYYYXYYMXXMYYMXYXMYMXMMXMMXMXYYMXXYMXXYYXYXXYXYXXYYMXYMMMX
YMXMMXXMXXMMXYYXYXYXYYMXYYMMMMYXYMMXYXYXYXXMXYXXXXYXMYXMXMYXMYYYXYYMYY
MMXXXYYXXXYXXXMYXMXMXMYYMYMYYYYYMMYYXYYYYXXXXMYMMXMYYYYMYMMMXMXMMMXXMX
YXMXXMMXMXYXMMMMYYMXXXYXXMMYYMYXYXXYYYXYMXYMYXXXMXYXXMYYXXXXMMXXYMMYMM
YYYMXYXYMMXMXMYXMYYMMMMXXYXXMMYYYXXYYXMMXXMXMMXXYXMXYXMXXMXYYYMXMXXYXY
MYXMYXYMYXMMYYXMXXMXMXYXXYYXYXYXXXXMXXXYMMXMXXXXMXYXYXXXXXYMMYXYXYXXMM
YXMMYYYMYYMMXXYMYMYYYYYMXXMYYXXXYMMMYYMXYMYMMMYXMXYYXMYMMYXXYYXMYYYMXY
XYMXYYXYXMMYMMYMMYXYXXMMYMMYXMMMYYYYMMXXXYXYYYMYYXMXMMYMYXMYMMMMYXXMMY
MMXXXXXYYXMMYYMMXYXMYXXXXYMXMXMMYXMYMYXYYYMYYYXMMYMMXYMXXXXYMMYYYXMXMX
XYMYXMXYYYYXMXXXMYXMMYYXXXYXYYYYMYMYXMMYMXYYYXXXXYYMXMXMYMXYMXXMMMYMXM
XMXYXXMYYYYMXXYXXYMYMXMMMYXXMMYMXMMXXYMXYXYMMYYYXMYMXYXYMYMYYYXXMXMXYM
XYXYXXMXXXYMYMXYYMXXYMXXMXYYMXMXXXYYMMMYXYMXYMMXXXMMMMXYXYYMYMMMYMMXXX
MMXMMYMMYMXYXMXXMXYXXMYMMYYXXXMXMXXMXYYMYYYMXYMYYMMMYMYYXMMXXXYMYXMYMM
MXXMYYMMMMYXYMXXXMYYYXMXMXMMMMXMXXMMMYYXYXXYXMYMMYXXMXYXMYYXYYMXMMYMXX
XYMXYMYXXXXYMMMXYXYMMMXXXYXXMMMYMYYYYYMMXXMYXMYMMMYXMXXYYYMXXXYYYYYYYX
MYYYMYYMMXMYMYYMYYMXXMXYXXXXXYXYXXYYMXXMYXMYMYMXMYXXMXYMMMXMXYMYXYMXYX
MYYYMMMXXXXMYMXXYMMXMYXXXMYMYMYYXMYYYYXMMYXYMXMXXMXXYMXYXXYMMXMMXXYMXY
XXXXMXXXXYMMMYYYMXMYMXYMYMMYMMXXYYYYMXMYMXXMMXMXMMYMXMYXMXYMYXXMYMYMXM
MMYYXMMMYYXYXXXMMMXMMYXMXMMMYYYYMYXXYYMMYXYYMYXXMMYXYYYXMMYXYXYMMYMYMX
MYXXMYMMMYYXYMYMYYXYYXXMMXMYMYMMMMYMYXYMMYMYYXXYYMXYXYXYXMMYMMXMMMYXXX
XMXXYYXMMMYXMXXMMXMYMXYYYMYXMYXYYXMYYYYXMMYXXYXXXYMXYXXXMYMMYYMMYXMXMY
XXXMYYMYYXMYYYMYXMYMYXXYMXYXMYMYXYYXMYYYMMYXXXYMXXXMYXMMYXYMMXMMMYXXXX
MYMYMYYXYXMMXXYXXXMYXMXXMXYYXMYXXMMXMMMMXXMXXYMMMXYYMMYXMYMMMXXXMYMYYM
XXMYMYXXYYMMYMMYXXXYYYXYMMXXXYYYXXMMXYYYYMMXYMXMMYYMMMYYYMMMYXXYYMYMYY
XMMXMXYMYXYYMXMYMXXXYMYMYYMXMXXXMYXYMXMMYXYXXYYMXXMYYYXYMMXXXMXMMMMXMM