;Mapa hecho por Ian Sanna
;Los elementos en el mapa corresponden de la siguiente manera
;  X: Valle
;  Y: Montaña
;  M: Mar

; Empezando el nivel:
YXXXXXXXXMMMMXXXXXXXXXXXXXXXXXXXXXXXXXXY
YXXXXXXXXXXXXXXXXXXXXXXXXXXXXXXXXXXXXXXY
YXXXXXXXXXXXXXXXXXXXXXXXXXXXXXXXXXXXXXXY
YXXXXXXXXXXXXXXXXXXXXXXXXXXXXXXXXXXXXXXY
YXXXXXXXXXXXXXXXXXXXXXXXXXXXXXXXXXXXXXXY
YXXXXXXXXXXXXXXXXXXXXXMMMMXXXXXXXXXXXXXY
YXXXXXXXXXXXXXXXXXXXXXMMMMXXXXXXXXXXXXXY
YYYYYYYYYYYYYYYYYYYYYYYYYYYYYYYYYYYYYYYY
YYYYYYYYYYYYYYYYYYYYYYYYYYYYYYYYYYYYYYYY
YYYYYYYYYYYYYYYYYYYYYYYYYYYYYYYYYYYYYYYY
YYYYYYYYYYYYYYYYYYYYYYYYYYYYYYYYYYYYYYYY
YYYYYYYYYYYYYYYYYYYYYYYYYYYYYYYYYYYYYYYY
YXXXXXXXXXXXXXXXXXXXXXXXXXXXXXXXXXXXXXXY
YXMMMMXXXXXXXXXXXXXXXXXXXXXXXXXXXXXXXXXY
YXMMMMXXXXXXXXXXXXXXXXXXXXXXXXXXXXXXXXXY
YXMMMMXXXXXXXXXXXXXXXXXXXXXXXXXXXXXXXXXY
YXXXXXXXXXXXXXXXXXXXXXXXXXXXXXXXXXXXXXXY
YXXXXXXXXXXXXXXXXXXXXXXXXXXXXXXXXXXXXXXY
YXXXXXXXXXXXXXXXXXXXXXXMMMMXXXXXXXXXXXXY
YXXXXXXXXXXXXXXXXXXXXXXMMMMMMMMXXXXXXXXY
YXXXXXXXXXXXXXXXXXXXXXXMMMMMMMMXXXXXXXXY
YXXXXXXXXXXXXXXXXXXXXXXMMMMXXXXXXXXXXXXY
YXXXXXXXXXXXXXXXXXXXXXXXXXXXXXXXXXXXXXXY
YXXXXXXXXXXXXXXXXXXXXXXXXXXXXXXXXXXXXXXY
YXXXXXXXMMMMXXXXXXXXXXXXXXXXXXXXXXXXXXXY
YXXXXXXXXXMMMMXXXXXXXXXXXXXXXXXXXXXXXXXY
YXXXXXXXXXMMMMXXXXXXXXXXXXXXXXXXXXXXXXXY
YXXXXXXXXXXXMMMMXXXXXXXXXXXXXXXXXXXXXXXY
YXXXXXXXXXXXXXXXXXXXXXXXXXXXXXXXXXXXXXXY
YXXXXXXXXXXXXXXXXXXXXXXXXXXXXXXXXXXXXXXY
YXXXXXXXXXXXXXXXXMMMMXXXXXXXXXXXXXXXXXXY
YXXXXXXXXXXXXXXXXMMMMXXXXXXXXXXXXXXXXXXY
YXXXXXXXXXXXXXXXXMMMMXXXXXXXXXXXXXXXXXXY
YXXXXXXXXXXXXXXXXXXXXXXXXXXXXXXXXXXXXXXY
YXXXXXXXXXXXXXXXXXXXXXXXXXXXXXXXXXXXXXXY
YXXXXXXXXXXXXXXXXXXXXXXXXXXXXXXXXXXXXXXY
YXXXXXMMMMXXXXXXXXXXXXXXXXXXXXXXXXXXXXXY
YXXXXXMMMMXXXXXXXXXXXXXXXXXXXXXXXXXXXXXY
YXXXXXXXXMMMMXXXXXXXXXXXXXXXXXXXXXXXXXXY
YXXXXXXXXXXXXXXXXXXXXXXXXXXXXXXXXXXXXXXY
YXXXXXXXXXXXXXXXXXXXXXXXXXXXXXXXXXXXXXXY
YXXXXXXXXXXXXXXXXXXXXXXXXXXXXXXXXXXXXXXY
YXXXXXXXXXXXXXXXXXXXXXXXXXXXXXXXXXXXXXXY
YXXXXXXXXXXXXXXXXXXXXXMMMMXXXXXXXXXXXXXY
YXXXXXXXXXXXXXXXXXXXXXMMMMXXXXXXXXXXXXXY
YXXXXXXXXXXXXXXXXXXXXXMMMMXXXXXXXXXXXXXY
YXXXXXXXXXXXXXXXXXXXXXXXXXXXXXXXXXXXXXXY
YXXXXXXXMMMMXXXXXXXXXXXXXXXXXXXXXXXXXXXY
YXXXXXXXMMMMXXXXXXXXXXXXXXXXXXXXXXXXXXXY
YXXXXXMMMMXXXXXXXXXXXXXXXXXXXXXXXXXXXXXY
YYYYYYYYYYYYYYYYYYYYYYYYYYYYYYYYYYYYYYYY
YYYYYYYYYYYYYYYYYYYYYYYYYYYYYYYYYYYYYYYY
YYYYYYYYYYYYYYYYYYYYYYYYYYYYYYYYYYYYYYYY
YYYYYYYYYYYYYYYYYYYYYYYYYYYYYYYYYYYYYYYY
YYYYYYYYYYYYYYYYYYYYYYYYYYYYYYYYYYYYYYYY
YXXXXXXXXMMMMXXXXXXXXXXXXXXXXXXXXXXXXXXY
YXXXXXXXXXXXXXXXXXXXXXXXXXXXXXXXXXXXXXXY
YXXXXXXXXXXXXXXXXXXXXXXXXXXXXXXXXXXXXXXY
YXXXXXXXXXXXXXXXXXXXXXXXXXXXXXXXXXXXXXXY
YXXXXXXXXXXXXXXXXXXXXXXXXXXXXXXXXXXXXXXY
YXXXXXXXXXXXXXXXXXXXXXMMMMXXXXXXXXXXXXXY
YXXXXXXXXXXXXXXXXXXXXXMMMMXXXXXXXXXXXXXY
