;Map made by Santella Agustin
;element index
;  D : Diert
;  M : Mountain
;  W : Water

; starting the level:
DWWDDDDDDWDWDDDDWDDDDDDWDDDDDDDDDWWDDDWWDDWWDDDDWDDDDDWDDWDDDDDWDDWDDDDDDDDWDWDDDDDDDDWDDWWDDDDDDDDD
DWWDDDDDDDDDIDDDDDDDDDDFDDDDDDDIFDDDDDDWWDFWWWWWFWFDDDDDDWDDWWDDIFDDDDDFIDDDWFDFIFDDDDDDGDDDDDDDDDFW
DDDDFDDDWDDDDDDDDDDDDGDDDDDDDDDDDDWDDDDDDDWDDDDDWWDDDDDDFDDDDWWWDWWDDDIFDDDIDDDDDDDDDWDDDDIDDDDDDDDD
DDWWWDDFWDDDDDDDDDDDDDDDDDWWWFDDFFDDDDDDDDDWWDDDDDDDDFDDDDWFDDDWDDDDDDFDFDDMIDDDWFDDWWDDDFDDDDDDDDDD
WDDWWWDDWWDFDDDDDDMDMDDDDDFDDDDDDDDDDDDDDDWWDDDFDFDDDDDDDDWFDDWWDDDDDWDDDDDDDIDWWDDWWWDDDWWDDDDDDDDD
DFDDDDDDDDWWDDDWDDDDDFWDDDDDWDDDDGDDFDDDDDDDDDDDFWWDDDDDDDWWFDDDDDDFDWDDDDWDDDDDDDDDDDDDFDDDMDDDDDDD
DDDDDDDDDDDDWDFWDDDDDDDDDFDDWDDDDDDDGDDDDDDDWWWDDDDFDDIDFDDDDDDDDDDDDWDDDWWDDWWDFFDDDDDDDDDDDIDDWWDW
DFDDDDDDDIFWWDDDDDWWDDDDDDDDDDGDGDDDDDDFDDDDDDDDFDFWWWDDDDFDDDGDWFDDWWDDDDIDDFDDWWFDDDDDDDDDDDDDDMDW
WWDDDDDDDDWWDDDDDDDWDDDDDDIDDDDDDFDDDDWWDWDDDDDDDDDDDDDDDDDDDDDWWWFDDDDDWWDDDDFDWFDDIDFDDDDDDDDDDDDD
DDDDWDDDWWDDDDFDDDDWWDDDDDDDDDDDDWDDDDDDWFDFDDDDDDDDDDFDDDDDWDFDDDFMDDDDDDDDDDWDWWFDDDDDDDWDDDDWDDDW
DDDWDDDDGDDDDWWDDDFDDDDDDDDDDWWWDDDFDDDDDWDFDDIFWWFDDDDDDDDWDDWWDDWFDDDDDDDDDWWFDDDDDDDFDDDDDDDDDDDD
DDDFWDDFDDDWWDDDDDFDDDFWWWDDDDMDWDWWDDDDDDDWDDIFDFWDDDDDDFDDWDDFDDDDDDDDIDDDDFDDWWDDDDWWFDDDDDDDDDDW
DDDWWDFDDDDDWWDDWDDDDDDDFDWFDDDDDDDDDDDFWDDDDDDDDDDDFDDDFDDDDDDWDWDDDDDDDDDDDDDDDDDDDDDDDGDDDDDDDDDD
DDDDDDDIFDDWDFWFWWFDDWWDWWWDDDDDDDDDFWDWWDDDDWFDDDDFDDFWWDIFDDFIDWFWDDDWWDDFDFWWFDFDDDDDDFDDFWWDDDDW
WDDDDDDFDDDDDWDDDFDDDDFWWDDDDDDDDDDFWDDDFWWDDWWWWFDDDDDDDDDDDDDDFWWWDDDDDDFDDFDDDDDDDDDDDDFDMDFIDDFW
WFDDDDWWFDDDDFDFDDDDDFFDDDDDDDDDDDDDWWFDWWDDDDDDFDDDDDDDDDIDWDDDDDDDWDWDDDDDDDDDDDDDDDDDDDDDDDDDDDWD
DDDDDDDDDDDDDDDWDDMDFWWDDWWWDDDDWWDDDDDDDDDDIFDDDDDWFFDDDWFWWFDDDDDDWWWDDDDDDDDDWWDDDDDFDDDDDDDDDDDD
DDWDDDDDFWDDMDWWDDDFDDDFIFWWWDDFMDDDDDDDDWFFDDDDDDDDGFDDDDDDDDDDDDDDFDDDDDDDDWWWWDDDDMDWDDDDDWWFFDDD
DFWDDDDDFDDDDDDDDDDWWFDDDDDFDDDIDDDDDFDDDDDDIDDDDDMFGDDDWDDWWDFDMDIDDDDDMDIDDDDDWWDDDDDWWWDDIDDWWDDD
DDMDDDDDDDDDDDDDDDDDDDDDDDDWDDDDDDDDDDDDDDDDFWWDDDDDDDDDWFDDDDDDDWFDDDDDDDDFDDFDDWWDDDFFDDDDMDDFDDDD
DDDDDDDDDWDDDDDDDDDFDDDDDDFDDDFDDDDDDDWDDDDDDWDFWDDDDDDDDDDDFWDIDDDDDDDFDDDDMDDDDDDDDWWWFMDIDDDDDDDD
DDDDDDDDDDDDWDDDDDFDDDDDDDFDFFDDDDDDDDDDDDDFWWDDDDDDDDDWDDDDDDDDDDDDFDDDFDDDDWDDDDDDDWWFDDDDDWWWDDDD
DDDDMDDDDDDFDFWWDDDDDDMDDDWWWWFWWDDDDDDDDFWWDDDDDDFDDFWWDDDDDDDDDDDDDFDDDDDFDWDDDDFDMDDDDDDDDDDDDDDD
DIFDDWWDDDFDFDDDDDDDDDDDDDDDDWDDDDDDIDWWWDDDDIDFIDWDDFDFFIFDDWDFDDFDDDDDDDDWWWDWWDDDDDDDDDDDDDFDDDDD
DDWFDDDDDDWWWWFDDDDDWDDFDDDWWDDDDDDDDDDDDDDFFDWWDWWDDDDWWDDFDWWDDWWWDDDWDDDDDDDFDDDDDDDDDDDDDDWWFDWD
DDWDDDDDDDDDDDGDDDDDDDWWFDDDDDDDDDDDDDGFDDDWWWFWFDDDDDDDGDDWWDWWDIDFDDDDDDDDDDDIDDDDDDDFMDDDFDDDDDDD
DDDDDDDMDDGDDDDDDWWDDDDDDDMDDDDDDDIDDDFWDDDDDWWWDDDDDDDDDMDWWDDDDDDDDWWDDDDWDWWDDFDDDDDDDDDDDDDDDDFD
DDDDDDDDWWFDIDDDDDDDDDDDDDDDDDFDDDDDDDDDDDDMDFDDDDDDDDDDDDDDFWWWDDDDWWDWDDDDDDDDWWWDDFDDDDFDDDDDDFDD
DDDGFDDFDDDDDDDDDFDDDDDDDDWWWWWDDDDDDDDDWWDDDWDDDDDDDDDFDDDDDFWFDDDWDDFDDWDDWWDDWFDDDWDFDDDDDDDIDDDD
WDDDDDDDDDDDDDDDDIDDWDDDDDDGFDDFDFDDDDDIDDDDFWWWDFDDDDFWWDDDDWWWFDDDWWDDDDDDWWWDWWDDFWDWWWDDDDDDDWWD
WDDDWDDDDFDDDDFDDDDFDDDDDDIDDDDDDDDDDDWDDDDDDWFWWFDDDDFWWDDDDDDMDDWDDWWDDDDDDDDFDDDDDWWWWDWDDDDDDDDD
DWDDDDDDFDDDDWWFDDFDDDWWWDDDDFWFDDDDDFGDDDFDWFDDDFWWDDDDDDDDDDDDDDDDDDFDFWWFFDDDIDDFDDDDDWDDDDDDWWDD
WWDGDDDDDDDDWWWWDDDDFDDDIDDDDDDDDDDDDDDDDDDDDDDDDDDWWFMDDDDDDDDDDFDDDDDDDDWDWWDDDFDDFFDWWWWWDDDWWWDW
DDDDFGDDDDDDDDDDDDWWDDIDDDDDDDDDDDDDWDWDDDDDDDDDDDDWFDDDIDDDDDDDDDDDDDDDDDDDDDDDDDDDWWDDIDDDDDDDDDID
DDDFDDWWDDDDDDDDWWDDDDFWWFDDDDDDDDDDIFDDDDDDDWWDDDWDDDDWDDDDDDDDDDMDDDDDGDDDWWDFWDDDDDDDDDDDDDDDDDDD
DWDDDDDDWWDDDDDWFDDFDDDDDWWDWDDIFDDDDDDDWDDDDDDDDDWWDDFWFDDDDDDDDDFDDFDDFDDDDDDDDDDWDDDDFIDGDDDDDDWD
DDDDDDDFDDDDDDWWFDDWFDDDDDDDDDDDDIDDDDDDDDDDDDDFWWDDDDWWDWDDDDDDFFWWDWDDDDDDDDDDDDWWDDDDFFWDDDDWDDMD
DDDDDDDWDDDDWWWWDDDDDDDDDDWDFDDDDDDDDDDWFFDGDDWFDWDDDFDDWFDDDDDDDDDFDIFWDDFDDDDDDDDFDDDDDFWDDWWFDDDD
DDDDDDWWDGDWWDDDDDIDFDWWDDDIDDDDDDDDDDDWWWDDWWWDDWWDWWWDWWDWWDDDDDDWWDDDDDWWDWDDDDDDFWWDDWFDWFFDDDDW
DDDDDWWDDDDDDDDDDDFDWDDDDDGDWFDDWWDDDFWWDWDWWWDDDDDDDDWDDDDDDDDDDDDDFDDDDDDFWFDDDDDDDDDDDDDDDDIFIDDD
WDDDFDDDDDDDWWDDDDWFDDDDDDIDWDDDWFDDDDDDDWWDDDDDDDDDDDDDDDDFWDDDDDDDDDDDDDDDDDDDFDDDDWWDFWDDDDDDDDDW
DFDDDDFDDWDDDDDDFDDDDDWWDDDDDDDDWWDDDDDDWFDFDDDDDDDDWWDDDGDDDDDDDDFFDDDWDDDWDDDDDIDDDWWDDDDDDDMDDDDD
WFFDDFDDDDDWWWWDWWFFDDDDDMDDDDDDDDDDDDDDDDDDDIFMDDIFWWDWWFWDDDDDDDWWWDDWDDDDDDDDFDDIDFDDDDDDDDMDDDDD
DWWDDWDDDDDDDDDDFDFWWDDDDDDDDDFDFDDDDDDDDDDDDDDFDDDDDDFDFWWDWDWWDDDDDFFDDDDDDDDDDDDDDWWFDDDWWDDWDDDD
DDDDFWWDFWDDDDDIDDDDDFDDDDFDDDDDDDDDDDDDFDDDDDDDDDDDDDDDIFDFDDDDDDDDDWWDDDDDWDDDDFDDDDDFWDDDDMDDDFDD
DDDDDDDDDDDDDFDDDDDDDDDDDDDDFDDDDDFDDFDDDDDDDDFDDDDDDDWDDDDDDDDDDIDDDDWWWDDDDDDDWWDDDDDFWWDDDDDDWWDD
DDFDDDDIFDDFFGDFWWFWDDDDWWDDDFFDDDDDWWWDWDDDDDDFWWWWDFWDDFDWDDDDDFWDDDDDDIFDDDWDDDDDDDDDDDDDFDFDDDDW
DDDDDDDDDGDDDDDDDDDWWDDDDDWWDWWDDDDDDDDDDDFDDDDDDDDDDDWWDWWWFDFDDDDDDDDFDDDFWFDDDDDDDDFDDDDDDDWFDDDD
DWWWWDDDDDDDIDWDDDDDDDDDDDWDDDFDDDDDDDDDDDDDDDWWWFDDDDDDDDDDDFWDDDDDDDDDDIDFDDDDFWFDDDDDDDDDWDDFDDDD
DDDDDDDDDDDDDDWWWFDDDMDDDDDDDFWDDDDDFDDDDDDDDDDDIDWDDDFDDDDDDDDDDDDDDDDDDDDDDDDDDWDDDFDDDDDDDDDDDDDW
DDWWDFDDFDDDDDDDDWDDDDDDWWDDDDDDDDDDFDDFDDFDDDFFDDDDDFDDDDDDDDIDDDDDDDDDDDDDDDDDDDDWWWDDFWDDFDDDFDDW
DDDDWWWDDDFDDFDDFDDDDDFDFDDDDDDDDDDDDDDWDDDDDDWWDDDDDIDFDDDDDWDDDDDDDDDDDDDDDDDDDDDDDDDDFWWDDDDDDDID
DDMFDFWWDDDDWWFFDDDDDDDDWDDDDDDDDDFDDWWWDWWDDWWDDDDDDDFDDFDDFDFDDDDDDDDDDDDDDDDWWDDDDDDDDDDDGDDDDGDD
DDDDDDWWDDDDDFWWDDDDDDDDWDDWDDDDDWWDFDDMDDFDDDDDDDDWFDDDFDDDDDWWDDDDWWFDDDWWWWDDWWFDDDDDDDDDDFDDDDDD
DDDDDDDDDDDDFDDDDDDDDDDDDDDWDDWWDDDDWDDDWFWWDFWWDIFWWDDDDDWDDDFDDDDDDDDDDDDDDDDDWWDGDDGDWWDDDIDDDDDD
DDDWDDDDDDDDDDDFDDDDFGDDDDFDDWDDDDDDDDDDDDDDDDDDFDDDFDDDDFWFDDWDDIDDDDDDDDDDDDDDFFDDFDFWWDDDDDFFDDDD
DDWWDDDDFDDDDDDWDDDDDDDDDDDGFDDFWWDDDDDDDDFDDIDFWWDDFDDDDDDDDDWFDDDDDFDDDDDDDDDDDDFWDDDWWFDDDWWWDDDD
DDIDDDDDDGDDDDFWFDDDDDDDDWWDDDWDDDDDDDDDWWWWDDWWWDDDWWDDDDFWDWWDDMFDFDDDDDDDWWDDDDFDDFDDDDDDDDDDDWWD
DDDDDDDDDDDDDDDWWWDDDFDDDDDDDWWDIDDWDDDDDDIDDDDDFWDDDDDIDDDDDDMIDDDDDDDWDDDWDDDDDDDFDDFDDDDWWDDDDDDD
DDDDDDFDDDDDDDWWDDDDDDDDDDDDWDIDDDDDDDDDFGDWWDDDDWFDDDDDDDDDDDDDDDDDDDWWWWDWWFDDFDFDDWWWFDDDDDDDDDDD
DDDDWWDDDDDDDDWWDDDDDDDDDDDDWWDDWDDDDDDWWDDDDDWDWWDDDDDDDDDWWDDDDDDDDFDDDDDIDDDDDDDFIDDDDDMDDDDFGDDD
DWWDDDDFDDDDDDWDDWWDDFDDDFGFDDDDWWDDDDDDDMDDDFDDDDDDGDFDDDDDDDDDDDDMDIDDDDDFDDDDDDDDDFDDWWDDDDMDFDDW
WWDDIDDWWWDDDDWWDDDWWWDDDDDFDDDDDFIDDWWDDDDDDDDDDDDFDFDDDWWDDDDDDDDDDDDDDDDWWWWWDDDDDWWDDDDDDDDDWFDD
DDDDDDDDDFDDDDDDDDDDFDDDDDDDDDWWDDDWDMDDDDMDDDDDDDDDDDDDDDDDWWDDDDDDDDDDDDDDDDDDFDDDDWWDFDDDDDWWWFDW
DWDFDDDDDDDDDDDDDDDWWWDDFWWDDDDDDDWWWDDDDDDDDDFDDDDDDDDDDDDDDDDDFDDDDDDFDDWWDDDDWWDWDDDDDDDDDDDDDDDD
DWWWDWWDWDWWDDDIFDDDDDDDDWWWDDDDDMDDIDDDWDDDWWWDDDMDDDDDDIDDDDDDDDDDDDDDFFDDDDDDDDFDFDDDDDDDDDDDDDDW
DDDDDFDDDDDDDDDDDDDDDDDWDDDDFDFDDDDDDDDDWWWWDDWWWDGDDDDDDDDDDFDDDDMFDDDDWWDDDIDWDDDDDDDDDDWWDDDWWDGD
DDDDDDDDDDDDDDDDFMDIDWWWDDDDDDDDDDDDDDIDWDDWWDDDFDDDDDDDDDDDWWDDDDFWWDIDDDDIDDDWWDDDDDWDDDDDDDFFDDDW
DDDFDDDDWWFDDDWWWDDDDDDDDDDDDWWWDDDDDDDFDFWDFWWDDDDDDDWWWDDDDDDDDDDDWDFDFDDFDDDDWDDDDDWWDDWDDDDDDDDD
DDDDDDDDDDDDWWDDDDDDDDDDDDFWDGDDDDDDMFDDDWFWWDDDDDFWWDDDDWWDWWDDWWWWWDDDDDDDDDWWWDDDDDDDDDWWDWFFWDDD
WWFDDDDFDDDDDDDFDDDDDDDDDDDDDDWDWWDGDDDDIDWDWFDDDDDDDDIFDDDDDFDDDWDDDDDGDDDDDDDDIDWFDFDDFWWDWWDDWDWW
DDFDDDFDDDDDDWFWDDDDDDDDDDDDDFWWDDDDIDGDDDWDWWDDDDDDDDDDDWWWDWDDFWDDDDDDDDDDWDDDDDDDDWWWWFDDDDDDDDDW
DDIDDDDDDDDWWWDWFDDWWWFDDFWDDDWDDWWDFDDDDFWWDDDDDDDDDDDDFDDDFDDDDDFWWDDDDDDFWWDDDDDDWDDDDDDIDWDMDDDD
DDDDDDMDDDDDWDDDDDDWFDDDDDDDDDDDWWDFWWDFWWWDDDDDDDDFDDDDDDDDDDDDDDFDDMFDDIDDWDDDDDDDFDDDFDDDWFDDDWWD
DDFDDDFDDFDDWWDDDWWWWDDFWWDDDDMDDDDDDIDDFDDDDDFDDDFWWWDDDDDDDDFDDDDDDDWDDFWWFDDDDDDDDDDDDDDDDWWDDDDW
DWWDDDDGDDDDWWWDDDDDDDDDDDDDDFDDDDDDDDDDDDMMDFDDDWWFFWWDDDDDDDWDDDDDDDWFDDDFDDDDDWWWWWDDDDDDFWDDDDMD
DDDDDDDDDFWWDDWWDDDDDDDDDDDDWWDDDDDWFDDDDDDFDDDDDDDMDDDDDDDDWDWWDDDDDDGDDFWWFDDDDDDDDWDDDDDDFDDDDDDW
DDDDDDWDDDDDDDDDFDWDDDWDDDDDDDDDWDFWDDDDDDFDDDDDDDDDDDDDDDFWWDIFIDWWDDDDDWWWDDDDWDIDDDDDDDDIDMDDDDDD
DDDDDDWWDDDDFDWFDDDDDDWDDDFDDDWDDDDDDDDDDWWFDDDDDDDDWWWDDDDDDDDDDFDFWDDGDDDDDDDDDDDDDDDDDDDDDDDDDDDW
WDDDDDDDDDWWWDWDDDDDDWWDDWWWDDWDDDDDDDDDDWDDDDDDDDWWDDDDDWDDDDDWDWDDWDDDWWDDDDWWDDWDWDDDWWDWDDWDDDDD