;Map made by Santella Agustin
;element index
;  D : Diert
;  M : Mountain
;  W : Water

; starting the level:
WDDDDWWDWDWDDWDDDDWWDDDDDDDDDWDDDDDDDWDD
DDDDDWDDDDDWWDIDDDDDDDDDWWDMDDDWWFDDDDFW
WDIFDWDDDDDDDDDGDDDDDDDDDDDIDDFDDDDDDDDD
DDDDFDDDGDDDDWWDDDDDDDDDDDWDDDDDDDFDDDWD
WDDDDDDDDDDDDDDDDDDDDWFDDWDFDFFDDFDDDDDD
DDDDDDDWDDDDDDDDDDDWWWDDDDWWDWWDDDDGFDDD
WDDDDDFDDWDDWDDDDDDDDDDDDFWWDDDDDDWDDDDD
WDDDDDDDWWWDWWWDFDDDWWFDDDDDDDDDDDWDDDDD
DDDDDDDFDDDWWFDDDDDFDDDDDDDDDIDFDFGDDDDW
DIDWDDDMIDDDFWFDDFWWFDFDWFDDMDFWDDDDDDDD
DDDWDDDDDDDDDDDDDDDDDDDDDFDDDDWWFDDDDDDD
WDDWDFDDFDDDDDDDDDDDFWDDFDDDDDWDDDDDWDDD
DDDDDDDDWWDDIDDDDDDDDDDDDDFDWWWDDDDDDDDD
DWDDWDDDFDDDDDDWDDDDDDDDDDDDDDFWDDDDDDDD
DWDFWWDDDDDDDDDDFDDDDIDDDIDDDDDDDFDDDDDW
DDFDDDDDDDDWWWDIDMDDDDDDDDDDDFDDDWWDDDFD
WDWDIDDDDDWWDDDDDDDDFWDWDDIDDDDDDDWWDWWD
DWWWDDDDDIDDDDFDDDDIDWWDDDDDDDDDDDFDDDDD
DDIFDFGDDDFDDFWWDDDDWDDDFDIDDDDWDDWDDFDD
DDDDDDDDDFDDDDDFDDWWWDGDDDDDDFFDIDDDDDDD
DDDDDDDWDDDDDDDDDDDDDDFDDDDFDWWFDDDWWDFW
DDDGDDWDDDDDDDDDDDFDDDWDWWDDMDDDDGDDDDDW
WDDDDDDWDDDDDDDDDWWDDDWDWDWDDDDDDDDDDDDD