;Map made by Santella Agustin
;element index
;  D : Diert
;  M : Mountain
;  W : Water

; starting the level:
DWDDDWWDDDWDDDWDDDDWDDDDDDDDDDDDWDDWWWWDDDDDDDDDDWWDWDDDWWWDDDDDWDDDDDDDDDDWDDDDDWDDDWDDDDWDDWDWWWWD
DDDDFFDDDDWDDDDFFWWDDDDDDDDDIDDDDFDDIDDDDDDDDFDMDDDWDDDDDDDDWDDDDDDDDDDDDGDWWDDDWWWDWWWWFDDDWDWDWDDD
WFDDWWFDDDDDDDWWFDDWDDDDDWWFDWDDDIFDDDDDDDDDDDDDDDDWDDDDDFDDDDMDDWDDDGFDDDWDDDDFDDDFDWWWDFDFWWWDDWFW
WDDDDMDDDDDDFWFDDWWWDDDDDFWWWDDDDDDDDDWWFDDDDDDDDDDWDDIDDDDDFDDDDDDDDDDDDDDDDDDWDDDWDDDFDMDDDDDDFWWD
WDDDDDDDDDDDWWWWWWFDDDDDDDDDDWDDDDDDDDDDDDDDWFWWWDDDDDDDDDDIDDFWWDDIFDDDDDWFDDWWDDFWDWWWDDDMDDDDDDDD
DDDDDDDDDDDDDDDDDIFDFDDDDDFDDIFIDMDDDFMFDWWDWDDWWDWDDDIDWWDDWDDDDDFDDDDDDDDDDFDDDDDDDDGDDDIDDDDDIDDW
DDDDDDDDIDDDDDDDDDIDDDDDDDDDDFWDDDDDFDDDFDDDDDFDDDDDFDDDDDDDMDDDDDDDDDGDDFDDDDDMDDDDDDDDDDFDDDDDDWFW
WWDDDDFDFWWDFMDDDWDDDIDDDDDDFDWWDDDDDDDDDDDDDDWWDDDDDDDDDMDDDDDDDDDDDDDDWWDDMDDDDDDDDFDDDDDDDDDDDWWD
WDDDDDDDDDDFDIDDFWDGDDDDDDDDWWFFDDDWWDDDDWWWDDDDDDIDDDDDDDDDDDDDDDDDWFDDDDDDDDDDDDDDWWFDDDDDDDDDDMDD
WWFDDDDDDIDMDDDDDDDDDDWDDDDMDWWFDDWWDDDDIDDDWWWWDDDGFDDDDDDDDDWFDDDWWDDDDDFDFDDDWDDDDDDDDDDIDDDDDDDD
DFFDDDDDDDDDDDDDFDDDDFWWWDDFDDDFDDDDFDDDDFDDDDGDDFWDDDDDDIDDDDDDDDDDDDDDDDDFDDDDWDDFDDDWWDDDDDDDDDDD
DWDDDDDDDWWDDDGDWWDDDWDWDDDWWDDDFDDDDDDDFWWFDDDWWDDDDDDDFDMDDDDDDIDDFDDWDDDDDDFDDFGFDDFFDDDDDWWDDDFW
DDDFDDDDDDDDDDDDDDWWFWWDDDDDDDDFDDDDIFDWWDDDDDDDDDDDDDDDWFDDDDDDIDDFDDDDDDDDDDDDDDDDDWWDDDDFDDWDWDDD
WFFWDDDDDDWFWDDFDDDDDDFDDDFDDDDDFWDDDIDDDDDDFDFFWDDDDDFDDDDDFDDDDDDDDDDDWDDIFDDDDDDFDDDDDDDDFWFWWDDD
DDDDDDDDDWFDDDWWDDDDDDDDMDWWWDDDDWFWWDFIDDFWWDWDDDDDDDDDDDDWWWDDDDDDFDDDDDDDDDDFWDWWDIFDDDDDDFDDDDDW
WDDFMDFWWDWWDDDDFDDDDWWFDDDDDDDWDDDDDDDMDFDDMDDDDDWWDDDDFDDDDWFDDDDDFDWWDDDDDDDDDDDDDIDDDDFDDDDDDWWD
DDDDDWWDDDDDDDWWWDDDWWDDDDDWFDDDDDDDDDDDDDDDDDDFWWDDDMDDDDDFFWDDDDDDDDDDDDDDDDWWDWDDDDFDDDDDDDDDDDDW
WWDDDDDDDDDDDDDDDDFWWDWDDDDWWDDDDWWDDDGDDDDDDDDDDDDDDFDDDIFDFWWDDDFDDDDDWWDDDWWWDWDDDDDDFWDDDDDDFDDD
WFDDDDFDDDDDDDIDDDDGDWWWWWDDDDDDDWWFDFDDDDDDMDDDDFDDDWWFDDFFDDDDDDIDFDDDDDMDDDDDDWDDFDDWWWFDFDDFDDDW
WDDDDDWWDWDDDDDDDDDMDDDDDDDDFDDFWDDDDDDDDDDDDDDFDDDDDDWWFWWWDDDDDDDDWDDDDDDGDDDDFDDDMDDDFDDDWDDDDDDD
DDDDDDDDDDDDMDDDDDDDDDDDDDDDFDFWWDDDDDDDDDDDDDDWWDWWFDDDIDMFDDDDDDDWWWWFDDDDWWFDDDWWFFDDWWDDWWDDWDWD
DDDDDWDWWDDDDDDDDDDDDDFDDDDDDDWWDWWWDDDDWWDDDDDWWFDDWDDDDDDDFDFDDDDDDDDWDWDDDDDWFDDIDDDDDDDWDDDDMDDD
DDDDWWFDDDDDDDDFDDDDFDDFDDMDDDDFWDFDDDDDDDDDDDDDFFIDDDWWDDWWWDDDDDFDDDWWDDDDDDWWDWDDDDDDFWWWWDDDDWDW
DWDDDDDDDFDDDIDDDDDDWWDFDFIDDDDDGDWDDDDDDDDDDDWDWWDDDDDDMDFDDDFDDDDDIDDDDDDFDDDDDMDDDIFMDDDIDFDDDDDD
WWWDDDDDWWDDDDWWDDDDMDFWWWDDDDDDDWWDDDDFFDDDWWWDDDDDDFDDDDGFFWDDFDWWDFDDDDDDDDDDDDDDDMDDDDFFDWWDDDDD
DDDDDFWWWDDDDDDDDDDDDDDDDDDDDFWDDDDDDDDWWDDDDDDDFDDDDDDDDDDDWWDDDDDDDWFDDDDDDFWDGDDDDDDFDFWWDDDDDDDD
DDMDDDDDDDWWDDDDFDFWDDDDDFDDDDDFWDDDDDDDDWDDDDDDDFDWDDDDDDDDDDWWDDDIDDDWWDDDDDDDDMDDWWDDDDDWDDDDDDDD
DDDWWDDIDDDDDDDDWWWDDDDDDDDFDDDDDDDDDDDFWWDFWDDDDWDDDDDDDDFFFIFDDDDDDDDDDDDDFDDDDDDDIDWDWFDWDDDDDDDW
DDDDDDFDDDFDDDDDDFDWDDDDDDDDDDDDDDDDDDDDDDDDDDDDDWDDDDWWDDWWDDDDDDDDDWWDDFDDWWDDDDWDFWWWWDDDDFDDDWWW
DDDDDDDDFDDDDDFDFIDDDDDDFWWDDDDIDDDDDDDDDDFDDDDDWWDDDDDDDDDFDDDDDDDDDDDDDDDDDDDDDDWWDDDDDDDDDDDDDDDW
DDDWDDDDDDFWDDDDFDDDDDDDWDWDDDDDDDDWWDDWDDDDDWWDDDFDDIFDDDDWFDDDDDDDWWDDDDFDDDDDDDDDDDDDDDDDDDWDWDDW
DWWWDDWDDDDDDDDFDDDDDDFWWDDDDDDDIDDDWWDWWDDDDDDDDDDDDDDDDDDWWDDDDDDWDDDFDDDDDDDDDDWFDFDDDDDDDDWDWWWD
DFDWWWDDDDDDDDDDDWDDDDDDFDDDWFDDDDDDDDDDFDIDDFDDDFDDDDDDDDDDDFDDDFWDDDDDDDDDDDDGDDWDDDDDWDDMDFDDDDDW
WWWDDDDDWWDDDDMDFDDDWFDDWWDFWFDDDFDDWWDDDDDDWWDDFDDWWDFDFDDIFDDDFDDWDDDDDDDWDDDDFFWDDDDDWDDDDDDDDFDD
DWFDFDDDDDDDDDDDDDDDWDDDGDDDDDDDDDDDDDDWWWWFDDDDDDDDDDWWWDDFWFDFDDWWDDDDDDDWDDDDDFDDDDDDWWDDDDFDFWWD
DWWDDFDDDDDFDDDDDDDDDDWDDDDDDDDWDDWFDDDDDDDWDDDFFDDDDDDDMDDWWDDDDDDDDDDDDWDWWDDDDDDFDDDDDDDFDWWDDDFW
DDDDDWDDDWDDDDWFFFDDDDWDDDFDDDDDDFDDDDDDDDDWWDDWWFDDDDDGDFWWDMDDWWDDDDDDDDDDDDDDDDDWWWDDIDDDDWWWWDDD
DDDDDWWDDDDDDFDDWWDDDWWDDDWWWWFDDDIDDDDDDDDWWWDWWWWWDWDDDDDDDDDDDDDDDDDDDDDWWDWDDWDDWFDDDWWDDDFWDWDD
DDDDDWWWDDDDIDDDDDDDDWDWWWWWWDDDDDDDDDDFDDDDDDWWDDDDDWWWDDDDDDDDDDDDDDMDWWDDFWWWDDDDWWFDDFDDDFDDDWDD
DDDDIDDDDDWDFDFDDFDDDDDDDDDDWDDFWDWWDDDDDDFDDDDDDFDDMFWWDDDDDDDDDWWDIDDWDWFDDDDDDDDDDFDFWWDDDWWDFDFD
DDDDDDDDDDDDDDWWFDDDDDDDDDDFDDMDDDDIDDMDDDDDMDDDDDDDDDDDDDDDDWFDDDDDDDDDDWWDDDDDDDDWWWWWDWDDIFDDDDDD
DIDDDDDDDDIDDDDGDDDWWDDDFDDDDDDDDDDDDDDDDDDDDDDDDDDDDWDFDFDDWWWDDDDDWDDIDDDDDFDDDDDDDDDDDWWDDDDDDDDD
WFDDWWDWDDDDDDDDDDFWWWDFWWDDDWWDDDDDDDWFDFDDDDDDDDDWDDDDDDFWWDDDDDDWFDDDDDDDDDIDDDDDDIFDDDDDGDDGDDDD
WFDDDDDDDDDFDDFWDDWWWWDDFDDDDDWDDFDDDDWDDDDDDDDFDDDDDDDDDDDDDDFDDDDFWWDDFWDFDDDDDDDDDDDIFDDDDDDDDDWD
DDDDDFDDDDDDDDDWDDFDDDDDDDDDDFWDDDDDDDWFDDWWDDWWFDWDDDDDDDDFWDDMDDDDDDDDDDFDDDDDDDDDDDDDDDDDDWFMDDDD
DDDDDDDDDDDDDDDDDDWWDDFDDWDDDDWWDDDDDDDDDDDDDDDFWDDDDDFDDDDDDDDDDDDDDDDDDDDGFDDWFDDFFDDDDIDDDDDDDDDD
DWDDDDDDDDDDDDFDDDDFDDDDDDDDDDDDDDFDDDDDDDDMDWWDWDDDDDDDDDDDDDDDDDDFDDDWWDDDDDDDDDWWWDDDDIDDDDDDDDDD
DWWDDFDDDDDDDDWDDDDDDDDDDDDDDDDDDFDDDIDDDDDDDFDDWWWDDDDWWDDDDDDDDDDWWDDWDDDWDMDDDFDDDIDDDFDDDDFDDDDD
DDDDDDDDDDMFDFDDDWDDDWDDDDFWDFDDDDDDDDDDDDDDDDDDFDDDDDDDDFDFDDDDDDDDWWFDDDDWDDIDDDDDDDDIDDDDDDDDDMFD
WDDDDFDDDDFWDDDDDWDDWWFDDDWWDGDDDWDDDDDWWFDDDDDDDDDDDFDDWWWWFFDWDDDDDDDDDDDWWWDDWWWWWDDDDFDDDDDIFFDD
DDDDFDDDIFWWDDDDFWFDDDDDDDDDDDDDDDDDDDDDDDDFWWDDDDDDWWFDDDDFDWDDMFDFDDFDFDDDDDDDWDDDDDDDDIDDDDDDDDDD
DDDDDDDDDWWDDDDDFWDDDDDDDDDDDDDDDDDDDDDDFDDWWFWWDDDDDDDDFDDDDDDFDWDWWWWWWWDDWWFDDDDIDDFDDDDDDDDDDFDD
DDWDFWFDDDDDDIDDDDFDDDDDDDWDDWWDWDDDDDGDDDDDDDFWDDDDDDDWWDDDDDDDDDDDDDDDDDDWWWDIFDDDDDWDDDDWDDDDFWDD
DWFDDWFDDDDWDDDDDDDDDWDDDWWDDDIDWDDDDDDDDDDDWFDDIFDDDDDDDDFDMDDDDDDDDDFDDDWWDDDDFDDDWWWDDDDDFDDDDWDD
DWWDDDDFDDWDDWFDDDDDDDDWWWFDDDDDWWDDDDDDDDDDWDDDDFWDDDDDDDDFDDGDFDDDIDDDDDDWDDIFDDDDDDDDDDDDDDFDDDDD
WWFDDDDWWDDWDIDDDDDFDDDWWFDDDDFDDWDDDDDDDWFWWDDDDWWDFMDDDDFDDWDDDDDDDDDDDWWWDDDDDDDDDDDDFWWDDWWDDDDW
WFWDDDWWDWWWWDDDDDDDDWWWDDDDDDDDDDDDDDIDDDDDDDDFDDDDDDFWDDDDDWWDWDWDDDDDFDDDDFDGDDDDDDDDDDMDDDDDDGDW
DDWWDDDDDDWDDDDDDFDDDDDDDDDDDDDDDDDDFDDDIDDDDWDDDFDDFDDWDDDWWFDWWWWWFDDDDDDDDDFDDDDDDFDDDDDDDDDDDDDD
DFDDWWDDDWDDDDWWDWWDDWWWDDDDDDDDDFDDDIDDDDDFDWDDDDDDDFDWWDDDDWDDDDDDDDDWFDDWDFDDDDDWWDDDDDDDDDDDDDDD
DDDFDDDDFWWFDDDDDDDDWDWDDDDDDDDDDWWWDDDFDDWWDDDDWDDDDDDFDDDMDWDDDDDDDDDDDDDDDDDDDWDWDDDDDDDDDDDDDWFD
DWWWDDDDDDDDDDDDDDDDDDDWWWFDWDDDMDDDWDDDDDDMGDDDDDDDDDDIDDDDWWWDDDDDDDDFDDDDDDDIDWWWFDDDDDWDWWFDFWWW
DDDFWFWWDDDWDDDDDDDDFDDDDDGFDDDDFDDDWDDDDDDDDDDDFWWWWDIDDWWFDDDDDDDGDIDFDDGFDDDDDDDFDDDDDDWWFDDDDDDD
WWDWWDDFDDFDDDDDDDDDDDDDDDDDDDDDDDDDGDDDDDWWFDDDDDWDDDMDDWWWDDDDDDDDDDWWDDDDDDDDDDDDDFDDFDDDFWDDDDDD
DIDDWDWWFDDDDDDWWDWWDWWFWDDWWWDDDDDDDWDDDDDDFWWDDDWWDDDDDWWFDDDDDDDDDMDDDFGDDDWWDDDDDWDDDDDDWWDDDDDW
DDWDWWWDDDFDDDIDDFDDWDDDWDDDDDDDDDWWDDDDDDFWDDDDDFDDDDWDDDFDDDWWWDDDDDFDDDDDDDDIDDDDDWWWDDDDDIDDDDDW
DDDDDWWFWWFDDDDDWDFIDDDDWDDDDDDDDWWWWFDDDDFWDDDFWWFWDDDDDDDDDDDDWFDWWDDDDDDDDDDDDDDDIFDDDDDDDDIDDFDD
WDDDDDDDIDDDWWDWWDDDFDDDDDDFWFDDDDDDDDMDDDDDDDDDDDDDDDDDDDDDDDDWDDDDDDDMDDDDDDDDDDDDFDDDDDDDDDDDDWFD
DDDDDDDDDDDDDDWDDFIDWWDDDDDFWDDDDDDDDDDDDDDDFWDDDDDDDDDDDDDDDDWWWDDDDDDDDDFDFDDDDDDDWDDDDDFWDDDDDDDW
DFDDDDDFDDDDDDDDDDDDDWWFDDDDDFWWFFWDWDDDIFDDWFDDDDFWDDFIDDDDDDDDDDWDDDDDDDDDDDWDDDDDWWDDDDFDDWWDWDWW
WDDDDDFIDDDDDDDDDDDDFDDDDDFWFDDDDDDFWDFDFWDFWWFFDDDWFMDDDDDDFDDFWWDDFDDDDDDDDDWWDDDDFWDDDDDDDDDFDDDD
DDDDDDGDDFWWFDDDWWDWWWFDIDDIDDDDDFDDWDDDDDDDDDDDDDFWDDDDDDDDDDDDDFDDDDDDDDDDFDWDFDDDDDDDDDDDFDDDDDDW
WWDDDDDDDDDDIDFDDDFDDDDDDDDDFDDWDDDWWDDWWDGDDDDDWDDWDFDIDDDDDIDDDDDDDDDDDWDDWDDDWWDWWDDDDDDWWWFDDDDD
DDDDDDWWWDDDDDFFDDWDDDDFWWWDDDWDDFDDDDWWFDDDDFDDDDWWDGDDDDMDDDDDDDDIDDDDWWDDDDDDDDDDDDDDDWWDDDDDDDDD
DDDDDDDFDDMDFDWWDDWWDDWWFDDDDDDIDDFDDFDDDDDDDDDDDDDDDDDDDDDDDDDDDDIFDDDFDDFFDIDDDFDWDDDDDDDDDDFWDDDD
WDDDDDDWDFDDDDDDDDDDDWDDFDFDDFDDDDMFFDDIFDDDDDDDDDDFWWDDDDDDFFWDDDDDDDDDDFWWDFDIDWWDDDDDDDDDFWWDDDDW
DDDDDDFWWWDDDDDWWDDWWWDWWDDDDDDDDDDWDDDDDDDFDDWFDMDDWFDDDDDDDDDDDWDMDDDDWWWWWWFDDDDWWDDFDDGDDDWWWDDD
DDDDDDDDDDDFFDDDFFWDDDFDDWWFDDDFDDDDDDDDDDWWFDWDDDDFDDDDDDDDDDDDDDDDDDDWDDWWDDDDDDDDDDWWDWFDDDDDWWDD
DDDDWDIDDWWWWFDWWFWDWWDDDDDWWFDDDDDDDDDDDDDDDDIDDDDDDFWDDFDDDWFDDDDFDDWWWDIDDWFFDDDWDDFWWWDDDDDDIDDD
DDDFDDDDDDDDDDDDDDWFDDDDDFDDDDDDDMDDDDFDDDDDDDDWWWDDFWDDDDDDDDDWWDDDDDDDDDDDDWWDFWWDDDDFDDDDDDDDDDID
WDWDDDWDDDDDDDWDDDWWWDWDDDDDDDDWDDDDDDWWDDDDDDDWDDWWDDWDDDDDDDWWWDDDWDWDDWDDWWDDDDDWDWDDDDDWDDDWDDDD
