;Map made by Santella Agustin
;element index
;  D : Diert
;  M : Mountain
;  W : Water

; starting the level:
WDDDDWWDWDWDDWDDDDWWDDDDDDDDDWDDDDDDDWDD
DDDDDWDDDDDWWDIDDDDDDDDDWWDMDDDWWFDDDDFW
WDIFDWDDDDDDDDDGDDDDDDDDDDDIDDFDDDDDDDDD
DDDDFDDDGDDDDWWDDDDDDDDDDDWDDDDDDDFDDDWD
WDDDDDDDDDDDDDDDDDDDDWFDDWDFDFFDDFDDDDDD
DDDDDDDWDDDDDDDDDDDWWWDDDDWWDWWDDDDGFDDD
WDDDDDFDDWDDWDDDDDDDDWDWDWDDDDDDDDDDDDDD
DDDDDDDDDDFDWWWDDDDDDDDDDWDDWDDDFDDDDDDW
DWDFWWDDDDDDDDDDFDDDDIDDDDDDDDDFWWDDDDDD
WDDDDDWDDDDDDDWWWDWWWDFDDDWWFDDDDDDDDDDD
DDDDDDDFDDDWWFDDDDDFDDDDDDDDDIDFDFGDDDDW
DIDWDDDMIDDDFWFDDFWWFDFDWFDDMDFWDDDDDDDD
DDDWDDDDDDDDDDDDDDDDDDDDDFDDDDWWFDDDDDDD
WDDWDFDDFDDDDDDDDDDDFWDDFDDDDDWDDDDDWDDD
DDDDDDDDWWDDIDDDFFDIDDDDDDDDDDFWDDDDDDDD
DDDDDDDWDDDDDDDDDDDDDDFDDDDFDWWFDDDWWDFW
DDDGDDWDDDDDDDDDDDFDDDWDWWDDMDDDDGDDDDDW
WDDDDDDWDDDDDDDDDWWDIDDDDDDDFDDDDDWDDFDD
DDDDDDWWWDIDMDDDDDDDDDDDFDDDWWDDDFDWDDDD
WDWDIDDDDDWWDDDDDDDDFWDWDDIDDDDDDDWWDWWD
DWWWDDDDDIDDDDFDDDDIDWWDDDDDDDDDDDFDDDDD
DDIFDFGDDDFDDFWWDDDDWDDDFDIDDDDWDDWDDFDD
DDDDDDDDDFDDDDDFDDWWWDGDDDDDDDDDDDDDDDDD
