;Map made by Santella Agustin
;element index
;  D : Diert
;  M : Mountain
;  W : Water

; starting the level:
DDWWDDWDDDWDWDDDDWDDDWDDWDDDDDDDDDDDDDDWDDDWDWWDDDDDWDWDDDDDDDDDDWDWDDDDDDWWWDDDWDDDWWWDDDDWDWDDWWDD
DDWWDDWWDFDWDDDDDDDWDWDWWWWFDDDIDDDDDDDDDMDDDDDWWDDGDDDIDDDDDFWWDDFDDWDDDDDDDDFDDDDDDDWWWDDDDFWFDDDW
DDMDWWWWDWDWWDDMDDDWDIDDDFDWWDDDDFDDDDFDDDFDDDDDGDDDDDDDDDDDDDDDDWWDDDDDDDDDFWWDDDDDDDDDDDDDDDWDIDDD
DDGDDDDDWWFDDDDDWWDDDDDDWWDDDDDDDFDDDDWDDDWWWDDDFWWDWDDDDDDDDDDDWWDIDFDDWDWWDDDDFDDDIDDDDDDDDWWDDDDD
DDDDWDDDDDWWDWFDDDDDDDDDWWDDDDDDDDDWWDWDWWDDDDDDDDFWWWFWWDDDWFDDDDDDDWDDDDDDDDWWWFWWDDDDDDDDWDDDDDDD
DDDFWWWDDDDDDWDDDDDDDDDDDDIDDWDDWDDDDDDDFWDDDDDDDFWWDDFMDDDFDDIFDDDWWWFDDFWWFFDDDDDDDFDDDDDDDDDDMDDD
DDDMDDDWDDDDDDDDDDDDDDIDDDDIDDIDDDWDFFDDDWDDDDDFDDDFDDDDWWDDDFDFDDDWDDDDFDDDDDDDDDDDWWDDDDDDDDDFDDDD
DDDDDDDDDDDDDDDFDDDDFDDDDDDDDFDDDDDDWWDWWDDDDDFDDDFWWDDDDDDDDDDWDDDDDMDDDFDDDDDDDDDDDDDWFDDDDDDDDDDD
DDDDDDDDDDDDDDDDDDDDFDDDDDDWDWFDDDDDDDWFDDDDDMDDDDDDDMFDDDDGDDWWWDDDFDDDDWWDDFDDDDDDDDFWWWDDDDDDDFDD
DDDDDDDDDDDDDDDDDDWDWDDDWWWWFDDMFDDDDWDWWDDDDDDDDDDDDDDDWDDFDDDDDFDWWDDDDDDDDDDDFDDDDDDDDDWWWFWWFWWD
WFDWDDFDDDDDFDDDDDWWDDDDDDDDDFDDDFDDDWFDDFDDDDDDFFDGDDDFDDDDDDDWWWDDDDDDDDDDDDWWWDDDDDDDDDFDDFDDDDDD
DWWWDDDDGDDWWDDDDDDDDDFDDDDDDWWDDDDDDWDDDDDDDDDDDDDDDDWWDDDDDDDDWDDDDDFWWDDDDDDFWDDDWDDDWWWDDIDDDWWD
DWWDDDDDDDDDDDWWDDDDDDDDWWDDDDDFDDDDWDFDDDFDDDDDDDDDDDDIDDDDDDDDWWDDDDDDDDDDMDDDDDDDWWWWWWWDDDDDWDWW
WDWDDDDDWDDDDDIDWWDDDDDDDDDDDDDDDDDDFDDDDFWDDDDMDDDDDFWDDDDDDDFDDDDFWDFDDDDDDDWDDWWWWDDDDDDDDDDDDDDW
WDDFDFWFWWWDFDDFDDDFDDDDFDDDDDDDDDDDDDDDDWWDDIDDDWFWDFWWDDDDFDDDWWWDDDWDDIDFWWWDDDDFDDDDDDMDDDDDDDDD
DDDDDDDFWFDWWWWDDDFDMDDDDDDWDDFDDDDDDDDWWDFDFDDFWWFDDDDDDDWWDDDDDDDDFWWWDDDDDDDMDDDDDDDDWWFDDDDIDFDD
DDFWWFDDWWFDDDDDDDDFGDDDDDDWWDWFDDDDDWWDDDDDDFDDDDDDIDDDDDDDWDFWWWFDFDFDFWWFDDDFWFDDDDDDWDDDDDDDDDDD
DGFDWDDDDDDDIDDDDDDDDDDDDFMDDDWDDDDDDDDDDDDDDWWDDDDDDDDDDDDDWWWFDDDDWDDDDDIDWDDDWWWDDDWDDDDDDDDDWDWD
WDDFDDDDDDDDDWDDDDDDDDFDDDFWFWWDIDDWDDDDWWDDDDDDDDDDDDDDDDDDDDDDDWDDDDDDDDDDWDDDDDDDDDDDDDDMDDDDMDWD
DDDDDDDWWFDDDIFDDDDDFDDDDDWWFDFDDDDWWDDDDDDDDDIFFDDDDDDDDDDDFDDIDDDDMDDFDDDDWDDDDWDDDDDWDDDDWDDDDDDD
WDDDDFDDDDDDDDDDDDDDDDGFDDDDDDDDDDDDDDDWDDDDDDDDDDWWDWDDDDWDMFDDDMDFDDFDFDFDWDDDFDDDDDDWWDDDWFDDDDDD
WWWDDDDDDFDDDDDDDDDDIDDFDDDDDDDDWFDDDDDWWFDDDDDDDDDDFWWDDDDDDDDDDDDDDDDDDFWDDDDIDDMDDDDDDDIDDDFDDDDD
DDDDDDDDDDDDDDDDDDDDDDDDDDDDDDDDDDDDDFDWWDFWDFDGDWDDWWDWDDDIFDDDIDDDDDDDDDDFDDFDDDDDDDDGDDDDDDDDDDDD
DDDDFDDDDDWWDFWDDDDFDDDDDWDDDDDDDDDDDWWDFDDDDDDFWDDDDDDDDDDDFDDDDFDDDDDDWWDWWDDDWWDDDDDDDDDDDDDDDFDD
DDDDDDFDDDDDDDDMDMDDDWWDFDFDDWDDDDDDDDDWWDDDDDDDFDFWWDDDDDDDDDDDDWWFDDFDDDDDDDDDDDDDDDDDDDDDIDDDMDDD
DWDDDDDDGDDDWWDDDDDDDDDDDFWDDDDDDFDDDDWDDDWDDDDDDDDFDDDDDDDIDDFMDDFDDDDDDDDDDDDDDDDMDIDDDDDDDDWDGDDD
DWDWWDIFDDDDDDDDDDDDDDDDDDWWDDDDWWWDDDWFDFDDDDDDWDFWDDDDDDWDMDDDDDWWDDDFDDDDDDMDDDMDDDDDDDDDDDDDDDDD
DIFDDWFDDDDDDDDDWWFDDDDDDDDFDDDDDDDDDWFDDDDDDDDWWDDDDDDDDFWWDDDDFDWWWWFWDDFWWDDDGDDFDDDDDDDDDDDDWDDD
DDDFWWWDDDIFDDDDDDDDDDDDDDDDDDDDGDDDDDDDDDWDDDFDDDMDFDDDDDDDDDDDWWWFDDFDDDDDDDDDDDWFDDDDDDDDDIDWDDDD
DDDDDDDDIDDDMDWDDDDDDDFDFDDDDDIDDDDDIDDDDDDDDDDFDDDDWDFDDDDDDDDDDDDDFDDDDDDDDDDWDDDFDDDDWDDDDFDFWWDW
DDDDDDDDDFWDDDWWDDDDDDDDDDDFDDDDDFWWDDDDDDDDFDDDDWDWWDDDFDDDDDDDDDDWWDWWWDDDDDDDDDDDDDWWWFDDDWDDDDDD
WDDDDDDWDDDDDIDDWDDDDDDDDDDWDWWDDDDDDDDDDDDDFDDDFWWDDDDDWDDDDWWDDDDDFWFDDDDWDWWDDDDDDDDDDDDDDWDFFDDD
DDDDDDDWWDDDDDDDDDDDFDDDDFWWDWWDDDDDDDDDDDFWWWDDDWDDDDMFWDFDDDDDDDDDDDDDFWWWDDDDDDDDDDDWWDMDDDDWWDDD
DDDDDDDDDDFDDDDDFDDFDDDDDDDDDFDDDDDDDDDDDDDDWDDDDWDDDDDDDDWDDDDFDFDDMDDDDDFDDDDDDFDDDDMFDDDDDDDDDDDD
DDDDDDDDDDDFDDDFWWDDFIDDDDDFWWWDDDDFWWDDDDDDDDIFWWFDDDDDDWWDGFDDDDDDDFDDFDDFWFDDWWDDDDDDDDWWDDDDDDDW
WDDDDDDDDDDDDWWWDDDFDDDDDDDDDDDDDDDDDDDDDDDDIDMDDDDDDWWFDDGDDDDDDDWWFWDDWWDDWWDDWWDDDDDDDDDDDDDDDWWD
WDDFDDWWFDDDWWWWFFDDDDDDDDDDDDDDDFDDDDDDDDDDDGDDDDDDDDDDDFDWWWWDDDDDWWDDDGDFDDDDDDDDFWWFDDDDDWWDDDDD
WFDWWDDDFDDDDDDDDDDDDDDWDDDDDDDDDDDDDDDDDDDFDDDDMDWWWDDDFWDMFDDDIFDWWDDDDDDDFDDDFDDDDDDDDDDDIDDDDDDD
DDMFDDDDWWFIDDGFDDFWDIDDDWDDDDDDDFWDDDDDDDDDDDDDDDDDDDDDFDDDDDDDDDDFDDDDDDDDIDWWDDWFDFDFDDWWDDDIDDDD
WDDDDDDDFDDDDDDDDDDDDDDIDDDDFWWDDWDFDDDDDDDDDFWDGDWWDDWWDDDWDDDDDDDDDFDDDDIDDDDWWDDFWDIDFDDDDDDDDDFD
WDDDDWDFWDDDDDDDWFDDDDDDFDDDDDDDDDWWDDIDDMFWWDWWFWFDWWDDFDDDDDFDDDDDDWWWDDFDDDDWDDDFWFDDDDDDDDDDDFDD
DFDDWWDDWWDDDFWDWDFDDIFDDDDDDDDMDDWWDIDDDDDFDDDFDDDDFDDDMDFDDDWFDIDDDDDDDDDDDWFDDDFDMDDWFFDDDDWWWDDW
DWWFDDDDDWWDDWWDDMDDDDDDDDDDDDDIFDDDDDDDDFDDDWDDDDFWWFDDDDDGDDDDDDDDDDDDDDDDDDDDDDWDDDFWFWWWWFDFWDDD
WWDDFDDFDDDDDDDDDIDGFDDWWWDDDDDDDIDDDDDDDDDDWWDIDDDDDDDDDDDDFDDDDDDDDDDDDDDDDDDDDDDDDDFWWDDDDIDDDDDD
WWWDDDDDGDDDDFDDDDDDDDDDDWWDDDFWWDMDDDDDDFDFDDDDDWDDDDDDDFDFDDDDDFDDDDDDFDDFDDDDDGDDDDDDDMDDDDDDDDDD
DDDDDDDDDDWFDDDMDDDDDDDDDIDIDDWDWWDDDDDDFDDDDDDDDDDDGDDFWWDWWDDDDWDDDDIDWDDDDDDWWDDDDDDWFDDDDDDDDDDW
DDDDWWDDDWWWDDDDDMDDDDWDDDDDDDFDDDDDDFDDDFDDFFWDDDDDDDDDDDDDDDDDDDDDDFDWFFDDFDDDDDDDDDDWDDDDDDDDDDFW
DDWDDDDWWDDDWDDDDMDDDWFDWDFWWDDDDDFDFDDDDDDDDDWWDMDDIDDDDDDDDDDDDDDDDDDDWWDDDDDDDDDIDDDWWDWDDWFDDDWW
DDDDDFDDDDDDWWWFDDDMDDIFDFDFFDDDDDDDDDDDDDDDDDMDDDDDDDDDDDDDDDDDWWDDDDDDDDDDDDDDDWWFFDDDDDDDDDDDWWWW
DDDDDWWWDDDDDDFDDDDDDDDDDDDWWDDWDDDDFDDDDDDDDDDDDDWDDDDDDDDDDDDDDDDDDDFDDWDDDWDDDDWDDDDDFDDDDDDDWFDD
WFDDDDDDDDDFDDDDDMDDDDWFDDDDDWWWWDDFWDWDDDDDDDDWWDDDFDDFDDWDDDWDDDDDDDDDWWWDWWFDDDWWDDDDDDDDDDDWWWFW
DDDDWWDDIFDDDDDDDDFDDDWWDDDDDDDFFDDDWWWDDDDDDFDDDDDDDDDDDFDIDDDDDWDDDDDDDDFDDDDWDDDDDFWWFMDDDDDDIDDD
WDDDDWWWFDMMFDDDDDDDWWWDDDDDDDWWWDDDDDDDDDDDWWFDDDDDFDDFDDDDDDDDFDDFDDFDDDWWWDWWDDDDDDDWDIDWDDDDDDDD
WDDDDDDFWWDDMFDDFWWWDDDDDFWFMGDDDDDDDDDDDDFDDDDDDDDDDDDWDDDDDDDDDDDDGDWDDDDFDDMDDDDDFDDDDDFDDFWWDWWD
DDGDDDDDDDDGDWDDDDDIFDDDDWWWFDDDDDDDDDDDDDWDDDDDWWDDDDWDDDFDFDDDDDDDDWWDDDWWDDDDDDDDWDDDDIDDDDDDDDDD
WFDDDFDFWFWDDDDDIDDDDDDFDDDDDDIFDDDFWWDWWDWDDDDDDDIDFWDDDDWDDDDDDDDDDDDDFDDDDDFDDDDDDDWWFDDDDDDDWDDD
DDDDDDDWWDDDDDMDDDDDDWDDDDDDDDFDDGDDDDDDWWWDFWDWDDDDFDDDDDDDDFWWDDDDDDDDWWDDDWWDDMDDDDGFDDIDDDDDWWDW
WDDDDDDDFDDDDDDDDDWDDDDDIDDFDDDDDDFDDGFDDDDDFDFDDDDDDDWWFDFDWDDDDDDDDWWDDDDDDDDDDFIDWWFIDDDWWWFDDIDD
DDDFDDDWWDDFDDDFWDDDDDDDDDDDDDDDDDDDDDDDDFWDDDWDDDDFDDDDDDDDWWDDDWWWDDDDDDDDFDDDDDDDDDDFDDDDDWDGDDDD
DDFDDFDDDDFWDFDDWWDDDDIDFDIDDDFDWDGDDDDDDDDDDDWWWFDDDDDDDIDDMDDDDDDDDDIDDDDDDDDDDDDDDDMDDFDFWWDDDDDW
WDDDDDDDDDFMDDDDDDDDDDDDDDDDDFDDDDDDDDIDDDDDDWDDWWDDDDDDMDDDDDDIDDDDDDDDDDDDDDDDDGDDDDMDDDDDIFDFDDDD
DDDDDDFWWWDDDFWWDDDDFDDDDDDDDDDDDDDWDDDDMDDDDWDDFFDDDDDDDDDDDDDDDDDDDDDDDWWDDDDDDFWWDDDWWDWWDDDWFDDD
DIDDDFDDDDDDDDDDDDFWWDDDDDDDDDDDDFDDDDFDDWDDFWWWWWWFFDDDDDDWDFWDDDGDDDDDDGDDDMGDDDDDDDGFDDDDDDDDDWDW
DDDDWWDDWWDDDDFDDDDDDDWWFDDDDDDDWWWDDDDDFDDDDDDMDDDDWWDDFDDWDDDIDDDDDDDDDDWWDDDWWDDDMDDDDDDFWWDDDDDW
DWWDDDDDDDFDDFDDDDDDDDDDDDDDDDDDDDDFDDDDDDFDDDDDDDDDWWWDDDDWWDDDDWFFDWDDFDIDWWFDGDDDDIDDDDWWDDDDDDDW
DDDDIDDDDFWDDWWDDDDWDDDDDDDWWDDDDDDDDWWWFDDDDDDDWDDDFFDDDDDDDDDDDDDWWWDDDGDDFDDDFDDGFDDDDWDDDWDDDDDW
DDDDDDDDDDDDDFDDDDDDDDDMDDFDDDDDDDFWWDDDDWDDDWWDDDFWWWDDDDWDWWWWFDDDDDWWDDDDDDDDWWDDDDDDDWDFDDDDDWWD
WDDFDDDDWFDDDWWDDDDFWWFFDFMDDDDDFDDFDFDDWWWDDDDDDDDDFDDDDDWWDDDDDDDWWDDDDDDDDDDFDWWWDDDFWWDWWDDDDDWW
WDDIFGDWWDDFDDDDFDDDDFFDFDDDDDDDDDDWDDIDWWDDDDDDDDDDDDFDDDDDDDDDDMIDFDDDDDDDDDWWDDDDDDDDDDDDDDDDWFDD
DDDDFDDDDDDDDDDDDDDDWWDDDDDDDDDDDDDDDDDDDDDDDDDDDDDDDDDIFDFDDDDDMDDDFDDDDDGDDDWDDDDDDWDFDDDDDDDDDDDD
DDWFWWDDDFDDDDDDDMDMDDDDDWWDMFIFDDDDDDFWWFDWFFDDDDDDIDDFDDDDFDDDDDDDDDWWWDDDDDDDDDDDDWWWDDDDDDDDDDDD
DDIDFWWDDIDDDDDDDDDDDDDDDDMDDDDIFDDDDDDDDDWWWWDDDFDGDFDDDDWWWWDDDDFDDDDDDDDDDDMDDDDDDFDDDDDDFDDWDDDD
WFFDDDDDDDWDDDDDDDDDDDDWFDDWFFDDDWDDDDDDDDDDDDWDDWWDDDDDDDDDDDDDDDDDDDFWWDDIFDDDMDDDWWDDDDFDDDDDDDDD
DDDDDDDDWWDDDDDDDDDDDDFWWDDWWWDDWDDDWFDDDDDDDWWFIDDDDMDDDMDDFDDDDDDDMDFDDDDDDDDDDWWWFDDDDDDDDDDDDDDD
DDDDFFWDDDDFDDDFDDDDDDDDWDDDDDDDDDDDDIDDMDDDDDDDDDDDDDDDDDDDDDDWWFDDDDWFDDWWDDWDDDDDDDDFDFFDDDDDDDDW
DDIDWWDDDDDWDFDDDDIDDDDDDDDFDIDDWDDDDDDWDDWFDDDDDDWDDDDDDDFDFWDDWWFDDDWDDDDDDWWDDDFWDDDDDWDDDDDDDDDD
DDDDDDWWDFWWDWDWDDDDWWDDDFIFDDDDWWDDDWDWWDDDDDDDDFWFDDWWDWWFDWDDDDDDDFDDDDIFDDDDWWDDDDDDDDDDMDDDDDDW
DDFDDDDDDDDDFDDWWWDFDDDDFDDDDIFWWDDDDMFDDWDDDDDDFWWDDDDWDDDDWWDDDDDDDDDDDFDDDDDWWDDDDDDDMDDDDDDDFDDD
DDWDDDDDDDDDGDDWWDDWWDDDDDDDDDDDDDDDFDDDFDDDDDDWWDDDDFWWFDDDFDDDDFDDDDWDDWDDFWWWDDDDDDDDFDDGDDDFDDDW
WDWDDDDDDDWDDWDWDWDDDWDDDDWDDDWDDDDDWDDDDDDDDWDDDDDDDDDDDDDDWWWDDDDDDDWWDWDDDDWDDDWDWDDDDDWDDDDWDDDW