;Map made by Santella Agustin
;element index
;  D : Diert
;  M : Mountain
;  W : Water

; starting the level:
DDDDWWDDDDDDWDDDDDDWWDDWDDDDWWDDDDWDDDDDDWDWWDDDDDDDDWDWDWDDDDWDDDDWDDDDDDWWDWDWDDWDDDWDDWDWDDWWDDWD
DDDDDDDDDDDDDMFWWDDDDDDDDFMDDDDMDDDDDDDWFDDMDDDDDDDDDDMDDDDDFWWDDDDDWDDDDFDDDDDFDDDDDDDDDIFDDDDDDDDW
DDDDDIDDDDDDDDDDDDDDDDDDDDDDDDDDDWWDMDDDDDDDDFWDDDDDWWDDDDDDDDDDDDDDWWDDDDDDDDDDDDDDDFDDDDDDIDFIFDDD
DDDDDDDDDDWWDDDDDDFDDDDWWDDDDDDDDDIFDDDDDDDFDFDDDWDDDDDDDDDDDDWDDDFDDWWWWDDDDIDDDDDDDDDDDDIDDDDDIDDD
DDDDFDDDDDDFIDDDIDDDDDWFDDDDDDDFDDDDDDDDDDWWDDDDDWWDDWDDWWFIDDDDDDDDDDDDDDDIDDDDFFDDDDDDDDDIDDWWDDDD
DDDDDDDDDDDDDDDDDDDDDDFDDDDFDDDFDFDDDDDDDDDDDWWFDDDDFWWDDDDDDGDDDDDDDDDDWDDDDMDDDDDDDDDDDDDDDDWDDFDD
WDDDDDDDDDDDDDDFDDWWDDDDWDFIDDDWWWDDDDDIDDDDDDDWFDDDDDDDDDDDDDDDDDDDDDDWWWDDGDDDDDDDDDDDDDFWDDWWDDDW
DDDDDDDDDWDDDDWWDDDDDDDWWDDFDFWWDDWDDDDDDDWDDDDDDDDWDDDDFDWWWWDDDDDWDDMDDDFDDDFDDDDDDDDDDDDWDDDFDDWW
DDIFDDDDWWDDDWDDDFDDDFDDDDDWDDDDDFDFWWDGDDDDDDDIDDDWFDIDWDDDDDDMDWDDDDDDWWDDDDDDDDDIDDWDDDDDIDDDDDDD
DDDDDFWDDDDDDDWDDDDDWWDDDDWWWDDDDDDDDDDDDDDDDDWDDDWWDDDWFDDDDDDDDDDDDDDWWDDDDGDIDWDDFWWWDDDDDDDDDDDD
DWDDDDDDWDFWDDDDDDDDDDDDFDDDDDDWDFWDDDDDDDDDDWWDDDDDDDWDDDDDFDDDDDDDDWFDDDMDDMDDDDFDDDDDDDIDDMDDDDFW
DDDWDDDWWDDWWWDDDDMDDIDWWFDDMDWWDDDDDDDDDDDDDDDWDDDWDDWWFDDMDDFWDDDDWDDDDWDDIDWDFDDDDDDDDDDWDDDDDDDW
WDWWWDDDFWWFWWWWWDDDDDWFDDDDDDDDIDDDDDDDWDDDFWWWDWWWDDDDDDMDFDDDDDDDFDDDDDDDDDWFDDDWWDDDWWDWDDWFDWWD
DDDDMDWDDFWWWDDDDDDDDWWDDDDDDDDIDDDDDDFDWWDDWDDDDWWDDDDDFDDWWWFDDDDFDDDDDDDDDWWDDDDDDWDWWDWDDWWDDDDD
DDDDDDDDDDDWWWFFDDDDDGDDDWDDDDDDFDDDDDDDDDDFDDDDDDDDDFDDDDDDDDDDFDDDDDDDIDDDMDDDMDDDDDDDFWWWDDDDDDDD
DDDDWWDDDDDDDDDDDDDDDFDDFWDWDDDFDDDDDDDDDDDDDDDDDDDIFDDDDWWDMDDDDDFDDFDGDWWDDDDDDFDDDDIFWDDDDDDDDDDD
DDDWDDDDDDDDWWFDDDDDWWDDDWWWDDDDDDDDDDDDDDDFDDDDDDDDDDDFWDDDDDDWFWWDDDDFWDDDDDDIDWWDWDDFWWWDDDDDFDDD
DDDWWDDDDWDWFDDDDDDDDDWWWFDDDDFFFDDDDDDDDDDWWDDDFDDFWDDWDDDWFDDDDDFDDFDDDDDDFDDFDIDDWWDDDDDDFDDDDDDD
DDWFDDDDWWDDDWWFDDDDDDDDDDFWDDWWWDDDDDDDDDFWDDWFDDWWWDWWDDFWWWDDDDDDDDDDDDDDDDDDMDDDDDDDDDDDDDWDDDDD
DWWDIDDWDDDDWDDDFDDDDDDIDIDDDDDDDWDFDDDDWDDDDFDDDDFDFDWDDWDDDDFDDFDDDDDDDDGDDFDDDFDDDDDDDDDDDDWWDDDD
WWDDDDDWWFDDDDDDWWWFDFDDDDDDIDWDDDDDDDDWWDDDDDDDDFDDWDWWFWWDDFWWWWDDFDDDWDDWWDMDDWFDDDDDDDDDDDDWWFGD
DDDDDDWWDDDDDIDDDMDDDDDDDDDDDWWWWDFDDDDIDDDDDDDWFDDDWWDMDDDDDDDDDWDFDDFWWDDIFDDDFDFDDDDWWFFDDDDWWDFD
DDDWWFDDDFDDDDDDDDWWDDDDDDFWWDDGDDWWFDDDDDDDDDFDDDDDDWFIDDDDDDMDDDDDFDDDDWWDWWWDDDDDDDDFDDDDDDDIDDWD
WDDDDDDDFDDDDIDDDDDDDFDDDDDDDDDDDDWWDDDDDDDDFIDDDDDDDDDDDMDDDDDWWDFDDDDDDDWWDDDIDDDDDDDWDDDDDFDDDDDD
WDDFDFIFWDIDDDDDDWWDDWWDDDDDDDDDDWWDDDDDIDDDDDFDWDDDDDFDMDDDDDDDDFWWDDDDWWFDDDDDDDDDDDDDDFWDDDDDDDFD
DDWWWWDFDDDDDDDDFWWDIFDDDDDDDDDDDDDDWWDDDDDDDFWWWDDDDDDDDDMDWDDDWWDWWFDDDIDDDDDDDWDDDWWDDDWWDDDDDDWW
DDFDDDFWFDDDDDDDDDDDDDWDDDDFDDWDDDDDDDDDWWDWDDDDDDDDDDDDDDDDWDDDDDDWWDDWWDDDDDDDFWWDDIDDFDWWDDFWWDDD
DDWDDDDWDDDDDDDIDDDDDDDDDDDDDWWDDDDDDDDDDDDDDIDIFDDDFDDDDDDWWDWWDDDDDDWDWDDDDDDDDWDDDDDWWFIDDDDDGDDD
DWWWWDDDDDDDDDIDDDDDDDDDDDDDDDFDDFDDDDDFDDDDDDDDGDWWDFDFDWWDDDDDDDDGFWWWWDDDDDDDWDWDFDDDDDDDDDDDIDDD
DDDDDDDDWWWDDDDWWDDDDDDDDDDWWDDDDDMDDWWFFDDDDDDDDMFWWWDDDDDFWWWWDDDDWFDDDDDDDDDDDWWDWWDIDDDDDDGDDDDD
WFFDDDDDDDDDDDDDDDMDDDDDDDWDDDDDDDDFDDDDDDWFDDDDDIDDDDDDDDFDDDDDDDDDDDDDDDDDDDDDDDDDDDDMDDDDDDDDWDDD
WWWWDDDDGDDDDDDDDDFWWWFDDWDDDDDWDDDWWDDDDWWFDDDDDDDDDDDDFWWDDDFDDDDDDDDDDDDDDDMDDDDDDDDDDGDDFWDDWDDD
DDDDDDDDDDDDDFDDDDDDDDDDDDDMDDDDDDDDDDDDDDDWWDDFWDDWWFDWFDDDWDWFDDFDFWWDDDFIDDDDFDDMFDDDDFDDDWDDWDDD
DDDDDFDDDDDDDDDDDDDFDDDDDDDDDDDDDWWDDDDDDDWWDDDFDDIDFIDDDIDDDDWFDWWFDDDDDDDDDFDDWWDDDFDDDDDDDDDFWDDW
DDDWWDDDWWDDDDDDDDDDFDDDDDDWDWWDDDWWDFDDDDDDDDWWDWDDDDFDFDWWDFDDDDDDDDDMDDDDDWWDDDDDDDDFWDDDDDDDDDDD
WDDDDFDFDDDDDDMDDDDWWDDFDDDDDGDDDWWDDDDDDDDFDDDDDDDDDDDFDDDDFDDDDWDDDDDDFDDDDDWWDDDDFDDDDFDDDDDDDDDD
DDDDDDDDDDDDDDDDDWWDDDDFDWDDDDFDDDDDDFDDDDDDDFDDDFWWDDDWDDFWWDDDDDDFWWDFDDWDDWDWDFDWWFDDDDDDDDDDDDDD
DDDDDDDWDDDDDDDDDDDDDDFDDWWDFWWFDDDDDDDDDDDDDFDDDDDWWDDDDDWDDDGDDDDDDDFDDDWDFWDWWWWFWFDDWDDDDDDDDDDD
DDDMDDDDDWWDDDDDDDDDDDDDDDDFDDDDDDDDDDDDDDDMDDDDDDDDDDDDDDWWDDDDDDWFWWDDDDDDDWDFDWDDWDDWWDWDDDDDDDDW
DFDDDDWDWWDWDDDDFFDDDWWDDDDWDDDDDDDDDDDDFDDDDDWWWDDDDDFDDDDWFDDDDDDDDDDDDDDDDIDDDWWWWFMDDDWWWFDDDDDD
DDDDDDDFDDDDDDDDWWDDDDDDDDWWDDGDDDDDDDDDDDDDDDFWWFDDDFDDDFDWDDDDDDDDDDDDDDDDDDDDDDDDDDDDDDDDDDDDDDDW
DWWDFDDDDDDDDDDDDWWFDDDDWWDIDDDDDDDDDDDFDDDDDIDDDDDDDWDMDDFDDDFDDDDDDDDDDDDDDDDDDDDDDWWDDFDDDDDDDDDW
DDDDDDDDDDDDDDWWFDDDDDDDDDDDDDDFWDDDDDFDDDDDDDFWWDFWWWFFDDMDDFWWDMDDFDDDDFDDDDDDDDDGDWDWDDDDDDFDDDFW
DDDDDMDWDGDDIDDDIDDDDDWDMDFDDDFDWWDDDWDDDDDDDDDDDDWDDDFDDDDDDDWWWFDFDDDDDWWWDDDWFDDDFWWWWDDWFFWWWWDW
WDDDDDWWWDDDDDDFDDDDDDWFMDDDWDWFWWDFWWWDDDDDDDDDDDDDDDDDDDDDDFDFDDDDDFDDDFIDWWWWWDDFWWDDDWDWWFWWFDDW
DWDDDDDDWWWDDDDDDFDDDFWDDDDDWWWDDDDFFDFDDDDDDDWWWDDDDFDDDDDDDDFDDDDFWWFFDDDDDDDDDDDDDDWDDDDDDWDDDDDD
DWDDDDDDDWDWDDDDWWDDDDWWWWDDDDFDDDWWWFWWDDDDDWDDFWDDDDFDIDDDFDDDDDDDFDDWWDFDDDDDDDDDDDDDWDDDFDIFDDDW
DWFDDDDDDDFDDDDDDDWWFDDDDDDDDDWDDDDDDDDDDDDDDWDDDDDDWDWWDDDIDDDDDDDDDDDDDWWDDDDDDDDDDDDDDDDDDDDDDDDW
DWDDDDDDDDFMDDDDDDDFDDWWFDWDDDDIDDDDDDFWDDDDDDDDDDDWWDDFDDDDDDDDDDIFDDDDWDDDDDDDWWFDDDWWDDDFWWDDDDDW
DDDDDDDDDDDDDDDDFWDDDDGFDWWDIDDDDDDDDWWDDDWWDDDDDWWDDDFDDDWWDDDDDDFDDDDFWWDDDDFDDDFDDDDDDFWWWWFDDDDD
WFWDDDDDDDMDDDDWWWFDWDDDDDDDDDDDDDDDDDDWWDDWWDDDDDDDDIDDDDDDDDDDDDDDDDDFWWDDDDDDWWFDWDDDDDDDDGDDWDDD
DFDDDWWDDDDDDDDDDDWDDDDDDDDDDDDDDDDDIDDDDFWWDDDDDDDDDDWDDDDDDDDDDDDDDDDWWDDDDDDDDDDDWWDWWWDDDDDDWDDD
WDDDDDDDDDDDWDWWDFDGDDDDDDFDDDDDDWWWDIDDIDDDIDDDDFWDDFDDDDDDDDDDDDDDDDDWDDDDDDDDWWWWDDDDDDDDFDDWWDDW
DDDDDDDDDDDDDDWWFDDDDDDDDDDDWDDWFFDDDDDFDDDDDDDDDDGFDDDDIDDDDDDIDDDFDDDDDDDDDDDWDDDFDDDWWFDDDDFDMDDW
DFWDDDDDGDDDDDDFWFDDDDDWWDDDDDDDDDDDDDDDFDDDDDDDGDDDDDDDDDDDWWDDFDDDDFDFWWWDDDDWDDDDDDDIDDMFDDMDFDFD
WFDDFDDDIDDDDDDDWWDWWWDDDWWWFDDDWFFDFDDDDDDDDDDDDIDDDFDDDIDDDDDFWWWDDDFWWDDDDIDWWDDDDIDDDDDDDIFDDDDD
DDFWWDDDDDDDDDFDDWFFWDDDDDDDDFDDWWWWWWDDDDDDDDWWWDDDWDDDDDDDDFDWDDWDFDDDDDDFWDDDDDDDDDDDDDDDDDDDDDDD
DDDDDDDWDDDDDDDDDDDWDFDDDDDDDDDDDDDIDDDDDDDDDDDDDDWDWWDDDDWWWWDDDDWWWDDDDDDDDDDDDDDFDDDDDDDDIDDIDDWW
DDFDDDDDDDDDMDDDDDDDWWDDDFDDDDDDFDDDMDDDIDDDDDDDDDWDDDDDDDDDDDDDDWWWDWDGDFDDDDWDIDDWWDDDDDWWDDWDDDDD
WDWFDIDDWDDDFDDDDDWWFDDDDWWDDDDDWDDDDDDDDDDFWDDDDWWFIFDDFDDDDWFDDIDDDDDDFWWDDDWWDWWDDMDDDFWDDDWWDDDD
DDDDDDDDWDDDDGDWWWWDDDDDWDWWDDDDDDWDDDDDWFDWWDDDDDDWDFDDDFDDDDDDDDDDDDDIDFDDDWDDDDWDDDWWDDDDDDFDDDDD
DDDDDIDWWWDDDDDDDDDWWDDWWDDDDDDDDDIFDDDDIDDDDWFDDDWWDDDWDWWDDDDDDDDDWDDDDDDDWWWDWWWWDIDDDDDWDDGFDDDD
DDDDDDDDDDDDDDDDDDDDWWDDDDDDDDDDDDDDDFDDDDDDDDDDDDDDDDDDDDWWDWWDDDDWWDDDDDDDWWFDDGDDIDDDDDDWFDDDDMFD
DDDDDDDDFWDDDDDDDIDDDDIDDDWDDDDDDFDDFDDDDDDDDDDDDDDDDDDDDDDDDDIDFDDDDDGDDDDDWDDDDDDDDDDDDWDWWWWDDDDD
WDDDWWWDDMDDDDDGDDDFWDDDDFDDDIDDDDDDDDDDFWWDDWDDMDDDDDDDDDWWDDDDDDDDDDDDDFDDDDDDDDDDDDDDWDDDDDDDDDDD
WDDDDDDDWDDDGDFDWWDDDDDDDFDDDDDDFDDDDDDDDDDDDDDDIDDDIDDDDDDDDDDDDDMDDDDWDDDIFDDDDDDDDDDDWWDDDDDDDDDD
WFIFDDIDDDMMDDDDDDDDFDDDDDDDDDDWWDDDDFDDDDDDDDDDDDDDDDFDDDDDDDDDIDDFDDDWWDDDDDDDDDDDDWWWDDDDDDDDFDDD
DWDFWDDDMDDDDDDDDDDDDDDDDDDIDDDDDDDDDDDWWDWWWWDDDDDDDDDFDDWDDDDDDDFDDWWDDDDDDDDDDDDDDDDDFDDDDIDDDDDD
DDDDDDDDDDDDDGFDDMDDDDDMDWDDIDWWFFDDDDDDDDDDWDDIDDDDDDDDDDDDDDDDDFWWWDDDDWFDWFWDDDDDDDDDWDDDDDWWDDDD
DDDDDDDDDDDDDDIDDFDDWDDDFWWWDDDDDDIDDDDWWWFFDDDDDDDFDDDDFDDDDDDDIDDDDDDFDDDFDDWWWWDFDDWWWFDDDDDDFDWD
DWWDFDDDDDDWFDDDDDDFDDDDDDDDFDDDDMDDDDDDDDDDDDDWDDDDDDDDWDIDDDDDFWDDDDDWWFDMDDGDDFDDDFDDDDDDWWFDWWWW
DDFWWDDDDDDWWWDDDDDDDDWWDDDDDDDDDDDFWWFDDDDDDDWWDIDIDDDDWDDDDDDFWFDDDDFDWDDDDDDWWWDDDDDDDDDWWWWDDDID
WDDDDDDWWDDDFDDFDDDDFDWDDDDDFWDDDDDDDDGDDDDWDFWWWDDDDDDDDDFDDDDFWWDDDFDDWDDDDDDDDDDDFDDFDDDDDDDDDDDD
DDDDDDDDDDDDDDDDMDDFDFWWDFWDFDDDFWFDDDDDDDDWDWWDWWDFDDDDDDDDDDDDDDIDDDDDWDDDDDGDDGDFDIDDDDDFDDWDDDDD
DDFDDDDDDDDDDDDIDDDDDDDDDDWWDDFDWWDDDDDDDIDWWDDDDDDDDDWDIDDDMDDMDDFDDMDWWDWWDDDDDDFDDDDFDDDDDDWWWDFW
WDWDFWWDDDDFWDDFDDDDDDDDDDIDDDMDIDDDDDWWFDGDDDDDDDDDDWWDDDDDIFDFDDDDDDDDDDDDDDDDDWWDDDWFDDDWWDDDFDDW
WWWDDDDDDDDDWWDDDDDDDDDDDDDWWDDDDDDDDDDDWFFDDDDDFDDDDDDWWDDDDFDDDDDDDDDDDDDDDDDDDDMDDDDDWWDDWWFFWDID
DDDWWDDGDDIFDDDDIDDDDDDDDIDDDDDDDDDDIDFWDDDFWDDDDDGDDDDDDDDWDWDDDDDDDDDDDDDDDDDFDFDWDDFWDDDDDWWDWWDD
DIDDDDDDGDDDFDDDDDDDDDDDDDDDDFDDDDWWFDDDMDDFDDDDDDDWDDDWDDDDDDDDDDDDDDDWWDDDDDDDFDFDDDDDDDDGDDDDDDFD
DDDDDDDDDDDDDDDWDWDDDDDDDDDWWDDDDDDDDDDDDWWDDDDDWDDWDDDWDDDDDDDDDDDDDDDDDDDDDDDDDDDDWDDWDDWDDDDDDDWD