;Map made by Santella Agustin
;element index
;  D : Diert
;  M : Mountain
;  W : Water

; starting the level:
DDWDDDDWDDDDWWDDDDDWDDDDDDDDDDDDDWWDDDDWDDDDDDWWDDDDDDDDWDDDDDDDDDWDDDDDWDDDDWWDDDWWDWDDDWWDWDDWDDWD
DDFDDDDDDWWDDDFDDDDDDDFWWWDWWDDDMDIDWDWDDDDDDDIDDDIDDDDDDDDFMDDDDFDDDWWDWDDDDDDDDDDDDDDDDDDDDDWWDDDW
DFDFIDDDDDDDDWWDDDDFDWDMDDDDDDDDDDDDIDDDDDDDFDDDDDDDDFDDDDDDDDIDIFDDDDDDWWDDDDDDDDDDDDDDDDWWWWDDDGDW
DWDWDDDDDDDDDDDFDDDDDDDDDDDDDDDDDDDDDDDDDDDDDDFDDDDDDDDDDIDDDIDDDWDDDGFDDDDDDDDDMDDFDDIDDDDIDDDDDDFW
DDDWWDDDDDDDDDDMDDDDDDFWWWDDDDDDDDDDDFDWFDWWDFDDDDDDDDDDDDDFDDDDDDDDDDDDDDDDFDWFDDDDDDDDDDDDDFDDDDDD
WDDFDDDDDDDDGDDDDDDDDDFDDDDFDDDDDDDIDWWWWDDDFIDFDDDDDDDDDDDDDDDDDDDDDDDDDMFDDDDFDWDDDDDGFDDDDDDDDDDW
DDDDDDDDDDWDDDDFWDDFDDDDDIDDDDDDDDDDDFWWFDDDDDWWFDWWDDDWWDDDDWDFDDDDDWDDMDDDDDDDDWFDWWWDGDDFWDDDDFWW
DDDDDDDDDFWWWDDDDDDDFDDDDDDDDDWDWWFDDWDDDDDDDDDDDDDDFDDDDDDDDDDDDWWWFWWDDDDDIFDDFWWDDDDDDWDDWWFDDDDW
WDDDDDDDDDDDFDDDDWDDWFDDDDDDDDWWDDDDDWDDDDGDDDWDDFDFWFDDDFDDFFDDWWFWWDDDDDDDDDDFDDWWDDDDDWDWDDDDDDDD
DDDDDDDDDDDDDDFFWWDWWFDDDDFDDWDFDDDDFWWDWWFDDDDDDDFDDDDDFIFDWDDDDDDDWWWDDFDWWFDDDDDDDWWDDWDDDDDFFDDD
DWDDFDDMDDDDDFDDFDDDDDIFDWFDDDWWFDWDDFDFDDDDDDFDFWWWDDDDDFDDWFDDDDDDDWWFWWWDDDDDDDDFFWFDFDDDDDDDDFDD
DDDDDDFDDDDDDIDDDDIDDIDDDDDDDDDDDFDDDDDDDDDDDDDDDDDDDDMDDWDDDDDMDDWDDWDDDDDDDDDDDDDWWDDDDDDDDDDDDWDD
DDDDWDDDDDFDDFDDDDDDDDDDGDDDDDDDWWDDDDDFDDDDDDDDDFDDDIDDDDDDDFDDDDWWDDDDDDDWWDDDDFWWDDDDDFDDDDWDWWDD
DWWDDDDDDDDDWWFDDDFDDDDDDDDWDDDDDDDFDDDIDFDDIFWWFGDDDDWDWDDDFDDDDFDDDDDDFDWFDDDDDWDDDDDDDDDDDDDDFWWD
DDFDDDDDDDWWDDFDDDDDDDDWWFDWWDDDDDWWDDDDWWDDDWWWDDDDDWWDWWWDDDDDWWWDDDDDWWWDDDDDDDWWDDDDDDDDDDDFDDDD
DDDDDDDDDIDDDFDDDDDDDDDDDDDDFDDDWWDDDDWWWDDDDDDWWFDDDDDWDDDDDDDDDDFDDDWWFDDDDDFWWWWWDDDWWDDWDDFWDDDD
DWFDDDDDDDDDDDDDDDDDFDFDDDDDDDDDDFDDDDDDDDDIDWWWFDDDDDDDDDDWDDDDDDDDDWDDDWWFDGDDIDWWWFDDDDWWDDWWDDDD
WDDDFDDWDDWDDDDDDDGFDDDDDDFDDDDDDDDDDFDDDDDDDDDDDDDDDDDDDDFDDDDMDDDDWWFDDDDDDGDFDDDDDDDDDDDDDDDDDDMD
DDFDDDDDDWWDDDWDDDDDDDDDWWDFDDDDDDWWDWFDDDDDFDDDDFWWDDDDDWFDDDDDDDFDDDDDDDDDDDWWDDDFDDFDDWDFDDDDDDDD
DDWWDDFDDDDDDDWDDDFDDDDDWWDFDDDDDFWDWDDFDMDDMDDDDWWDDWDDWWDDDDDDWDWDDDDDDDIDDDFDDFWWDFDDDDDDDFIDDDDD
WWWFDDDDDWDDDWWWFDDDDIDDDDDWFFWFDDWWWWWWFDDDDDDDDIDDDDFWFDDDDFDDWFWWDDDDFDDDDDWWDDDFDWDDDDDDFWDDFDDW
DDWDMDDDDDIDDDDDDDDDDDFDDDDWDWWWFDWWDDDDDDDDDDDDDDDDDFDWDDDDDDDWWDDDFDDDDDDDDWWDDDDDDDDDDDDDFDDWWFDD
DWWFDDDDDGDDDGFWWDWDDDDDDDWWDDDDDDDDDDDDDDDDDWWDDDFDFWWWDDIDDDDDDDDFDDIDDDDDWWDDDDDDDFDDDDDDDDDDDDFD
DDDDDIDDDGFDDDDDDDDDDDDDDDFDDDDDDDGDDDDDWWFDDDFDDDDDWDDDDDDDDDDDDDDDDDDDDDDWWWDDDDDDDDDDDDFMDDDGDDDD
WDFMDFDDDMDDDDMDDDDDDDFWWDDDDWDDDDDDDFDDFDDFWWWDDDDDWWWDDDDDDFDDDWDDDDDDDDDDGDDDDDDDDIFDDDDFDDDDDDDD
WDDDDDDFDDDDDMFWWDDDDDDDIDDDWWDDDDFDDWFDDDWWDDDDDDDDDWDDDDDFDDDDDDDDDDDDDDDDDDDDDDDDDDWFDDFDFDDDDDDD
DDDWWDDDFDDDDFDDDFDGDDDDDDDFDDDDDDDIDDDDDDDDDDWWDDDDDDDDDDDDDDDDDDDDDDDDDDDDDWWDDDDDWWWFDDDDDDDDDDDD
DDDDDDWWWDFDDDDDDMDFWWDDDDDWWDFDDDDFDDDFDDDDDDDDMDDDDDDDDDDDIDDDIFDDDDDDMFWDDDDDDDDWDDDDDDWDDDDWDDDD
DDDFDDDDDDWDFDDDDDFDDDDDDDDDDDWWDDDDDDDDDDDDDDDMDDDDDDDDDDDDDDDDDIFDDDDDDWWFIFDDDDDWWWWFDDDDDDDDDFWD
DDDDDDDDDDDDDFWDDDDDDWWDDFDDDDDDWWDWFDDFDDDDDFDDDDDDDDDDDDDWDDDDDFIDDDDDDDDDDDDDDDDIDDIDDDDDDDDDDWWD
DDDDDDDDDDDDWDDIFWDWWWDWFDDDDDDDDDWWDDDWWFDDDWFDDDDDDDDDDDWWDDDDDDDDFDIFDDDMDDDWWDDDFDDDDDDDIDDDDDDD
DDDDDFDFDDFWWDDDFIFDDFDDDDDDDDDDDDDDDDDDWWWDWWDDDDDDDDDDIDDDDWWFDDDWWDDDDDDFDDDFDDDDWDDDWWDMDGDDDDDD
DDDDFWWWDDDFGDDDWDDDDDDDDDDDDDDDFWDDWDWDGDDDDDFWDDWDDDDDDDDDDDWDDDDDGDDDDDDDDWWWFDIDDFDDDWFDDDDDGDDD
WFDDDDDDDDWDDDDFWWWDDDDDDDWFDWDDWWWDWDWWDDDDDDFWWFWWDDDDDDDDDDMDDDDDDDDDDWWWFDDDDDDDFWFDDDDDDDDDDDDD
DIDDDDDDWWWDDDDDDDMDWDDFWWWDDWDDDMDWWDDWWDDDDDDDDWWDDDDDWDDIDMDDDDDDDDDDDWFDDDDDDWFDFWDDDDDDDDDDFWWD
DDWWDDDDDDDDDDDDFWDWWFDDDDDDDDDDDFDDDWFWDDWDDDDDDDDIDFDDWWDDDDDIDDDDDDDDDDWDDDDDDWDDWFFDDDDDDDDWWWDD
DMDDDDGDDDDDDDDDFDDDFDIDWWDWWDDDFWDDDDFDWWWDDWWWDWDDDIDDDDDDDWDDDDDDDDDWDWWDWDDIDDDDDWWDWWWDDDDDMIDD
WDDDDDDDDDDDFFDDDFDDDDDDDDDDFDDDDWWDDDWDDDDDDDGDFDFDDDFDDDDDFDIDDDDDDDDDDDDDDDDDDDDWDDDDDDDDDFDDDDDW
DDDDDDDDDDFWWWDDDWDDDDDDDDDDDDWWDDDDDDDDDDDDDWDDDDWWWDWWDIFDDDDDDWDDDDFDDDDDDFDDDDFDIFWWWWWDDFFWWDDD
WDDDDDFDDDDFDDDDFDDDDDDMDDDDDFDDDWDDDDDDFDDDDWWFDDDFDDFDDDDDDDDDDDDDDDWDMDDIDDDDFDDMFDDDFWDDDWDDDDDD
DDDDDFDMDIDDDDDDDFDDDDDDFDDDDWDFWWDMDDDDDDDDDDDDDDDDDDDFDDDDDGDDDDDDDDDDDDWDFDWFDFDDWDDFDWWFDWWDDGDD
DWDDDDDFDDDDDDDDDDDDDFFDDDDDDDDDDDDDMDDDWDDDDDDDWDFDDDDDDWDDDDDDWWDDFDDWWDWWWDWDDDDDDDDWWDDDDDDDDDDW
DDDDDDDDFDDWWDDDDDDDDWWDDWWDDDDDDDDDDDDDWWWDDDDDDDWWDDDDWWWFDDDDDFDDDDDDDDDDDWWDFDWWDWWDDDDMDDDDDDDW
DDDDDDFDDDDDDDDDDDDDGDDWDWDDDDWFDDDDDDDDDDFDDDDDDDDIDDDDDDDDWWDDWWFDDDDFDWDDDDDDDDWWFWWDDDDDWWDDWDDD
DFDDDFWFDDDDWDDFDDDDDDFDDDDDWWWDWDDDDDDDDDDDWDFDDDDDIDWWWDDDDDDDWDWDDDDIDWWDDDDDDDDDDDDDDDDDMDIDWWDD
DWDDDDDFWWDWWFDDDDDDDFDDDDDDDWDWWDWDFDFDDDDFDMDFDDDDDDDFDDDFWDDDDWDDDFDDDDDDDFDDDDDFDDDDDDDDDDMDDWDW
DWWDWWDFDDDDDDDWFFDWDDDWDDDDWWDDDDDDDDDDDDDDDMDWWWDDWDDWDDDWDDDDDDWFDDDMDFDDDWFDDDDDDWWFDWDDDDDDDWDD
WDDDDDWWWDDDDDWWDDDWWDWWDDDDDDDDDDDDDDDDDFDDDDDDDDDDWWDWDWDWWDDDDWWDDDDDDIFDFDDWDDDDDWWWDDDDDDDDDWDD
DDDDWWWWDDDDDDDDDDDFDDDDDDDWWDDWWFDDDFFWWFDWDDDIDDDDDDDDDDDMFDDDDDDDDDDDDDDDGDFWDDWDDDDWDDDDWDFDDWWD
DDDDFDDDDWWDDDDDIDDDDWWWWDDDDDWDDDDDDWDDDDFDDDDDWWFDDDDDDDDDDDFWFDDWDDDDDFDDDDWWDWWDDFWWDDWDWWWFFDDD
WDDWWDDDDDDDWFGFGDDDDDDDDDDWWDDWWDDDDDDFWDDDDDWWDDMMIDDDDDDDDDDMDIDWWWDDDWDDDFDDDDDDDDIDDFWWWDDDWDDD
DDDDDDDIDFDFWDFDDDDDDWFDDMDDDDDDDDDDDDFWWDDDDDDDDDDDDFDDDDMDDDWDDDDDIDWDDDDDDDDWWDDDDDDDDDDDDDDDWWDD
DFDDDDFFDWDDWWDDDDDDFWWFDDDDDDDFDIDDDDDDDWDWWDWWDDDDDDFDDFDDDDDDDDFMDWWDDDDDDDDIDDDDFDDWDDDDDDDDDWWD
DDDDDDWWFWFFWWWWDDDIFFDDDDFDDDDDIDDDFDDFWDDDWWDWWWDDDFWDWWWDDDDDDFDDDDDDIDDDDGDDDFDDDDDDDDDFDWWDDDDD
WDDFDDDDDWFDDDDWDDDDDDDDDFDDMDDDDWDDDFDDDDDWDFDDDDDDDDWWWWWWWFDDWDDDDDDDDDDDDDDDDIDDGDDDDWWWDFDDFDDD
DDWWDDDDDWWWFDFDDDDDDDDDDDDDDWWDDDDDFDDDDDDDDDDWFDDDDIFIFDDDDDDDDDDDDDDDDDDFDDDDDDDDDDDDDDDFFWDDDDDD
WDDDDDDFDWDDDDDDDDDDFWWDDDDDDDDFDFWDGFDWWFDDFDDDDDWWDDWFDWWDDDDDDDDFWWFDDDDDDDDDWDDDDDIDDFFMFIDDDDDD
DFDDDDDDDDFDFDMDWWFDDDDDDDFDDDMDDDWDDDDFDDDDDDDDWWDDDFDDDDDDDDDDDDDDDDFDDDDDDDDDWDDDDDDFDDDDIDDDDDDD
WWFDWWWFDDDDWWFDDDDFDDFIDIFDDDDDDDDDDDDWDDDDDDDDWWDDDDFFDDDDDDDDDDDDDFDDFDDDDDDDDFWDDDDDDDDDFDDDWWDD
WWWFDDDDDFFWFDDDDDDDDFDDDDDFDDDIFDDDFWWWDDDDDDWDDDDDDDWWWWWWDDDDDDMDDDDWWDDDDDDWFFWWDDFDDDDDWDDWDDID
DDFDDDDDDDDDDDDDDDDWDDDDDDDDDDDDDWWFIDDDDDDDDDWWFWDDDWWFDDWDIDDDDDDDDDWDDDDDDDWWFDDDDDDDDDDDDDDWWDDW
WWWFFDDDDDDDDDDIDDWWDDDIFDDDDDDDDDDDDDFDDDWWDDDDDDDDDDDDDDDMDWWDDDDDDWWDDDDDDDDFDDDWFDDDDDDDDDDDDDDD
DDDDDDDWWDDDFWDDDWDDDDDFDDDFDDDFFDMDDDDDDFWWDDDDDDDDDDDDDDDDDFDDDDDDDDDDDDDDDDDDDDDWDDDDDDDDDDGDWWDD
DDDDDDDDDDDDWWDWWWWFDDDDDDFWFDDWWDDDWWDWWDWWWWDDDDDDDDMDGDDDDFDDDDDDFDDDIFDDIDDDFDDMDDFDDFDDWWDDDDDD
DDDDDDDDFDDDDDDDDDDDDDDFDDDWDDDDDIDDDDWWFDDDFDDWWDDDFDDDFDDDDWWFDDDDWWWFDDDDDDDDWDMDWDDDDDDDDDFWDDDD
DDDGDDDWWFDDDDDDDDFDDDDDDDDDDDDDDDFWFDDDDDDWDFDFDDDDWDDMDDGDFIDDFWWDDDDDDDDDFWDDDDDWWDDDDDDDDDDWDFDD
DDDFDDWFDDDDDDDDDDDDDDDDFDDDDDDFWDDDDDDDDDDDDDFDDDDDWDDDDDFDDDDFDDDIDWWFDIDDDDDDDDWFDDDDDDDDDDFDFWWW
DWFWWWDDIDDDDDDDFDMDDDDDDDDDDDDFDFDDIDDFDDDDDDWDDDFDWWDDDDWDFWDDDDDIDDDDDDDDWDDDMDFDDDDDDDDDDDDDDIDW
WWDDDDDDDWDDDDDWWDDDDDDDFFFWDDDDDDDIFDDGDDDWWWFDFWWDDDWDFWWDDWWDDFDDWWFDDDDDDDDDDWWDFDDDDFDGDDDDDDDD
DDDFDDDDDWWDDDDWWWFFDDDDWWDDDDDDDDDFDDDDWWDDDDDDDDIFFWWDDDDDDWDDWWDDDDDDDDFDDDWDDDDDWWDDWDDDWWDDDDWD
DDDDDDDDWDDDFDDDDDDFDDDDDDDDDDDGDDWWFFDDDDDDDDDFDDDDFWDDDDFDFWDDDFWDDWDDDWWDDWWFDDMDDDDDWFFDWWDDDDDD
DDDWDDDFGFDDIDDDDDDWWDDDDDDDFDDDDDDDDDDDDDDDDDDWWFDDWWWWDDDDDWDDDDWWDWWWWDWDDDDMDDDDDDIDDDDDDDDDDDDD
DDDDGDWDDDDDDDDFDDDDDDDDDDDDDDDDDFDDDDDDDDDFWDDDDDDDDDDDDDDDDWDDDDFDDFDDFWWWDFDDDDDDDDDMIDDDDFDDDDDD
DDDDDWDDDDWWDDWWDDDDDDDDDDDDDDDDFDFFMDDDDDDDWWWDFDFDDDWWWDDDDWWWDDDDDDDDIDDDDDDWWDDDDDDDDDDDDDDDDDDD
DDMDDWWWDDDDFWDDDDDDFIFDDDDDWWDDDDDFDDMDDWFDDDMDIDWWWWFDDDDIDDDDDFDDGDFIFDDDDGDFWWDDDDFDIDDDFDIDIDDD
DDFWFDWDDDDDDDMDDDDDDDWWDDFDMDMDWWDWDDDDWWFDDFDDDDFDDDMFDDDDDDDDDDDWFDDDDDWWFDDDWWDDDDDFDDDDDDDDDDDD
DDDDDDDDDDDDDDDDDDDDIDFDDDDDDDDFDDDDDDDDDDDDDWWDDDDDDFDDDDDFDWDDDDDWDDWWFDDDDWDDDDWDFDWWDGDDFDDDDDDD
DDDDDDIDDDDDDDDDDDFDDDFDDWWDDFDDDDDDDDDDDDDDWDDWDDDFWWFDDDFDFWWDDDDDDDDDDMDDDDDWWDWWWDDDDDDDWWDDDDDD
WWWWDDDDDDDWWDDDDDFFWWWDDDDDDWWDDDDDDDFDDWDDDDWWDFDDDFDDDDDDDDDWDDDDDDDDDDDDDDDDDDDDDDDDDDDFDDDFDDDD
DDDDWDWDDWDWDDDDDDWDDWDDDWDDDDDDWWWDDDWWWWDWDWDDDDDDDWDDDDDDDDDWDDDDDWDDDDDDWDDDDDDDWDDWDDDWDDDWDDDD