;Map made by Santella Agustin
;element index
;  D : Diert
;  M : Mountain
;  W : Water

; starting the level:
DDDDDDDDDDWDDWDDDWDWDDDDDDDDDWDWWDDDDDDDWWWWDDDDDWDDDDDDDDDDWDDDDWDDWDWDDDDDDDDDDDDDDDDWDWDWDDDDDWDD
DDDDDDDFDDDDDDDDDDDDDDDDDDDFWWDDDDDDDDMDDDDDDMDWWDWDDDDDDDFDDDDDDWWDDDDDDDDDDDDDDMDDDDDWWDDDDDWDDDDD
DDIDDDDDDDWDDDDDDDWWDDDDDDDDDDDIDWFDDDDDDDDDDDFWDDWDDDDDDFDDDDDDDDWDFDDDIFDDDDWDDDDDDDDDIFDDDDDDDDDD
DDDDDFDDDFWWWDFWWDDDDMDDDDDDDGDDDDDDDDDDDDDFWWWWDDDDDDDDDDDDDDDDDWWWWWFDFWDDDFWDDDDDDDDDDDDFWDDDDDDD
DDDDFWWDDDDDDDDDDDDDDDFWWDDWWFDDDDDDDMDGDWFDDDDDDDDDDDDDFDFDDDDDDDDDDWDFWDDDDDDDDDMDDDMDMMDDDDDDDDDD
WDDDDDDDDDDDWDDDDDDDDDDDDDDDDDDDWDDWWDDDDDDDDDDIDDDFDDDDIDDDDDDDDDDDDWDDFWFDDDDDDMDDFDDDDFDDDDFDDDDW
DDDWDDDDDMDDDDDDDDDFFFDDDDDDDDDDDDWDDDDDDDDWDDFDDGDWDDFWDMDDDDWWWWDDDDDDWDFFGFDDWDDDDDDDGDDDDDDFFDDW
DFWWFDDDDDDDDDDDWWDWWWDDDDDDDWWWDWWDDDFDDDDDDFDDDDFDDDDDDDDDDDDFWDDDGDDDFWWDFWWDWWDWWDFDDDDDDFWWDFDD
DWWDWWDDDDDDFDDDDDDDDDDDDDDDDDWWDDDDFWWFDDDDDDDDDWWFDDFFDDDDDDDWDDDDFWDDDDWDDDDDFWDDFDDDDDDIDDDDFDDD
WDDDDDDDDDFFDDDDDDIDDDDWDDDDDDDDDDDDDDDDDDWWFDDDDDDDWWWWWWWDDDDDWDDDDDDDDDWWDIFDDDDDDDDDDDDIDFFWWDDD
WDDDDDDDDDDDDDGFDDDDIDDDFDWWFDDDDDDDFDDDDDDDDWDDDDFDDDDDWDFDDFDWWWDDDDDDDDDFDDDDDDDDDDDWDDDDFWWFWDDD
DDDDDDDDDDDDDDDDWDDDDDDDDDFDDWDDDDDDDDDDDDDWDDDDDDDDDWDWWDWWDDDDDDDDDDDIDWDDDDDDDDDDDDDWWDDDDDWWDDDD
DDDFDDDDDDDDDDFFWDWWDFWDDWWDWWWDDDDDDDDWDDDWWFGFDDDWDDDDDDDDDDDDDDDDDDDDFDDDDWDDDDWWDDWDDDDDDDWDDDDD
DDDDDDIDDDFDGDDDWFDDDDDDWWDIDDWFIDDFFDDDDDWFDDDDDDDWDDIFDDGDMDDFFDDDFDDDIDDDDWWWWDDDDDWWFFDDDMDDDDDD
DDDDIFDWDDDDDDFWWDDDDDDDDDDDDDDDFDFWWFDDDWWWFFWDWDDWDDDDDDDDDDDWWDDDDDDDMFMDDWWWDDDDDDDDFDDDDDWDDDDW
DDDDDDDDDDDDDDDDDWDDDDDDDFDDFDDDDDWDWWDWWDDDDWWDDDDWWDIDDDDWDDDMDDIDDDMDDFDDDDDDDDWWFDDFWWDDDWWDWDID
WFDDDFDDWDDDDDDWFDDMDDDDDDDDDDDDDDDWWDDWFDDDDIDIDDIDDDDDFDWFDDDDDDDDDDDFWWDDDDDDDDDFWWWDFDDDDDDFDDDD
DDDDDWDDDDDDFDWWDDDDDDWWDDDDDDWDWDDDDDDWWWDDDDDDDFFDDMDDWDDWDDDWWDGFDGDDGDDDDDFDDDDDDDDFWWWDWFDDDDDD
DDDDDDDDDFWWWWWDDDDDDWDDFDDDDDMDDDDDDDDWDWWDDDDFDDDDWDWWWDWWWDDDIDDFIDDDDDDDDDDDDDDDDDDDDDDDDDDDDDDW
DDDDDDDDDDDDFDDDIDDDWWDFDFDDDDDDDDDDDDDDDDWWDFDWWDDWWDDDDDDDDDDWDDDDDDDDDDFDDWWFDDDDWWWWWWDDDDDDDDDD
DDDDFDDDDDDDWWDWDMDWWFDDDDDDDFDDDDDDDDWFDDDDDDDDDDDDDDDDDWWDDDDWFDDDDDDDIDWDDWWWWDDDDWDDDDDFWDDDDDDD
WDDWFDDDDDDFDDDDDDWWDDDDDDDDDDDDIDDDDWDWDDDDWFDDDFDDDDDWWDWWDDWWDDDDMDDWDWWFMDDDDDDDDDDDDDFWWDDDDDDW
DDDWWDDDDDWDDDDDDDFDWWWDDDDDDDDDDIFDDFWDDDIDIDDGDDDFWWDGDDIFDDDDDDDMIDFWDDDDDWDDDDDDDDDDFDDDDDWDDDDD
DDDDDFDDDFDDDDDDDDWWDDDDDDWDDDMFDDGDDDWWFDDDDDDDDDDWDDDDMDDDDDDDDIDFDDDWFDWWDWDWWFDDGDDWWDDDDDDDDDDW
WFDDDWFFFFDDDDDDDDDDDWWFDDDDDDDDDDDFDDFDDDDDDDDDDDDDDDDDDDDDDDDWDDFDDDDDDWWDDWDDDWWDDWWDDDDDDDDDFDDD
DWWFWWFWWWWDDDDFIDFDDDDDDDDDIDDDDDDDDDDDDDDDDDDDDDDFDDDDDDDDDDDDDDDDDDIFDDDWFDDDDFDDDFDDWDDDDDDWWFWD
DFDDDMDDFDDDFDDDIDDDDDWWWDDFDDDDDDDDDDDDDDWFDDDDDMDDDDDDIDDDDDDDDDDDDDDDDDDDDDDDDDFFDDDFDDDDDDDDDDDD
DWDFDDDWWDDDDDDDDDDDDDDDFWWWDDDGDWDDDDDDDDDDDDDMDIDDFWWWDDDDDDDDDDDFDDDDDDDFWWDDDDWWWDDDDDDDDFDDDDDD
DDDWWDDDDDDDDDGDDDDDDDDDFDDDMDIDDDGDDDFDDDDDDWFDDDDMDDFDDDWDDDDDDDDWWWDDDDDDDDWDDDDDFDDDDDDDDWWWWDDW
DDDDDDDDWDDDDDDDDWWWDMDWDDDDDDDDDDMDDDDDFDDDDWDDDDDDDFWDDWWDDDDDDWDDDDDDDDWWFDWWDDDDDDDDFDDDDWWWDDWW
DDDDDWDWWDWDDDWWDDDDDDDWWFFDDGDDDDDDDDDDDDWDDDDDDIDDDDDDDDDDFWDDDDDDDDDDDDDDDDDDDDDDDDDDDDDDDDDDDDWW
DDDDDDDDDWWFDDWDDDDDDDDWWDWDDDGDDDDIDDDDDDWWWDDDIDDFDDDFDDDDFDDWWDIDDDDDDDDDDDDDDDDFDDDWDDDGDDWWFDDW
DDDMDDWWDDDDDDDDDDDDFDFDDFDDDDDDDIDDDDMMDDDDDFDDFDDDDWFDDDFDDDDFDDDDDDDDFDDDDDDDDDDDDDWDDFDDWDDDFWWD
DFDDDDDWDDDDDDDDDIFDWDWWWDDDDDFWWDDDGFIDDDDDDDDDWFDDWWDDFDDDDFDDDDIFDDDFWWDFDDDDDDDDDDDDDWDDWWFDDDDD
WWDDDDWDDDDDDDDDIDWWWWDDDWWDDDDDDDIDDDDDDDDDDDDFWDWFDMDDDDDDDWWWDFDDDGDDDDDDDDDDFDDDDDDDWWFDWWWFDDDD
DDDDDDDWFDWDDDDFDDFDDDDDDDDDDFDDDFDFDDDDDDDDDDDDDDDDDFDDDDDDDDDWWWWWDDDDDDDIDDDDDDDDDDFWDDDWWDDDDDDD
WFDDDDWWDDDDDDDDDDGDDDDDDDDDDWDFDDDDDDDDDDDDDDDFDDDDFDDDDWWDDDDDDDDDDDDDDDDDDDDDFWDDDDWWFDDDDDDMDDDW
DWFDDDDDDIFDDDDDFDDWWDDDDFDDWWDWWDDDWWDDDMDDDDFWWDDDDDDDDDWDDDDDDDIDDFWWDDDDDDDDWWWDDDDDDDDDFDDDFDFD
DWDWDDDDDDDDDDDDDDDIDDDDDDDDDDDDDDDDDDDDDDDDFWWWFDDDDFDDDFWDFDDDDDDDDDDDFWWDDDDWDFDDDDDDDDIDDDDFMDDD
WWWWWDDDDDDWWDDFWDDDMDDDDFWDDDDDDDDDDDDDDDDDDDDDDDDMDDDDDDWDDDDDDDDDDDDDDDDDDDFWWDDDDDDDDDDDDDDWDDDW
DDIDWWWDDIFDDDDDWDDDDDDDDWWDDDWWWDFDDDDWDDDDDDDWDDWDDFWWDWWDFDDFWWDDDDDIDDDDDDDDFFDFDDDDDDDDDDDDDDDD
DFDDDDDDDDFDDDFWDDDDDDDDDDDDDDDDDWWFDDDDDDDIDDWWDDDDDDDDDDDDDDDDGDDDDDIDDDWDDDDDWWWWDDDDDDDDDDWDDDDD
DWWDDDDDDFWWDDDDWDWWDDDDWDDDWDWDWFDDDDDFDFDDDDDDDDDDDDDDDDDDMDDDFDDFWDDDWWDFDDDDFWWDWWDDDDFFDWWDDDDD
WDDDDDDDDWWDDDDDDDDDDDDDWWDDDDDDWWWWFDDWDDMDDDWWFDDFWDDDFDDDDDDWWDDFWWDDDDWWDDDIDFGDDFDDDDWWDDDDDDDD
DGDDDFWWDDDDDDDDDFDDDFDWDDDDDDDDWWDDDFWDMDDDDFDDFWWDWFDWWDDDDDDDDDDDFDDDDDDDDDIDDWDWDDDDDWDDDDDDGDDD
WDDDDGFDDDDDDDDDDDDDDWWWDDDDGFDDDDDDDDDDDWWDDWWDDDDDWWDDDDDDDDDDDDDDDDDDGDDDDDDDDDDDIDDIDWWDDDDDDDDD
DDDIFDDDDDFWFDDDDDDDDDFDDDDDDWWWDDFDDDDDDDDDDFDDDFDIFFDDDDDDIDDDGDWWDDWFDDDDDWDDDDDDDDDDDWDDDDDWWFDW
DDDDDDDDDDFDDIDDDDDDDDDDDDDDDDDDDFIFDMDWDDDDDDDDDDDDDDFDMDDDDWWDFDDDFDDDDDDDDDFMFDDDDDDDFDDIDDDDDDDD
WDDDDDDFWWDDDDDDDDIFDDDDFDDDWWDDWWDDDDDWWDDDDDDMDDDDFWDDDDDIFDDFDDDWWDDDDDDDDDFDWWDDDDDDDDDDDDDDDDDD
DDDDDDFDDDWWDDDIDDDDDDDDDDDDDDDDDDDDDDFDDDDWFDMDWWFDFDFDDDDDWWDWDDDFDDDDDDDDDDWDIDDDDDDDDDDDDDDDFDDD
DDDDDDDDDWWDFDWDDDFDDDFDDFDDDDDDDDDDDDDDDDFWWFDDDDDDDDFGDWDDDDDDDDFDDDIDDDDDIFWDDDDDDDDDDDDDDDDDDDDW
DFDDDDDWWWDDWWWWWFFDDFWFDDDWDDDDFWWDDDDDDDWDWWWDDDDDDDDDDWWDDWWDDDDDDDFDDDDDDWWFDDDDDDDDFWWDIDDDDDDD
WDDFDDDWFGDDDDDWDFWWDDDDDWWDWFWDDFWWWDWDDDWWWDWWFDDDDDDDDDDDFWWWFFDDDDDDDDDDDDDDDDDDDWDDDDDDDDDDIDDW
DDDDDDDWDDDDDDDIDDDFFDDDDDDWDDDMDDDDDDWDDDDFDDFDDDDDDDDDDDDDDDDDDWWWFDDWWFDWDDWFDDDFDDDFDDDDDDDDDDWD
WFDDDWWWDDDWWDDDDWDWDDDDDDDDDDDFDFDDDDWDDDDDIDWDDDDDDDDGDDDDDDDDDDDDDDDDDDDDDDDDDDWWDDDWWDDDDDDDDDDD
DDDDDDDDDDDDDDDDDWWDDDDDFDDDDDWDDDDFDDDDDIDDDDDDDFDDDDDDDDMDWDDDDDWDDDDDDDDFDDDDDWDFWWWDFDDDDDDDDDDD
DDFDDDDDDDDDDDDDDDFIDDDFWDDDDDDDDDWWDDDDDDIDDDDWFDDDFDDDWWDFWDDDDDDDDDDDDDDDDMDDWWDDDDDDWDWDDDDDDDDW
WDDDIDDDDDDDDDDDDDDDIDDDDDDFDDDDDDDDDDDDDDDDDDDWWDDWWDDDWDDWWDDDWDDDMDDDFDDDDDDDDDDDFDMDWDDDDDDDDDFD
DDDDDDDDWDDDDFDGDDDDDDDDDDDWDDDDDDDDFDDDDDDDDDWWDDDFDDDDDDDDDDIDDDDDDDFDDDDWFDDDDDDDMDDDWDDDDDGDDDDD
DDDDDFDWWDDDDWWDDDDWWFDDDDDWWDDFDWWDWDDDDDIDDDWWDDDWWWDDDDDDDDFDDDDDDDWDDDDDDDIDDDDDDDDWWWDDDDDDWWFW
DDDWFWDDDDDFWDDDDDDDMDDDDDGDDDDDFDDDDIDDDDDGDWWDDDDDDDFDDDDDDDDDDDDDDFDDDDDFDDIDDFFDDDDDIDGDDDDDWDDD
DDDDDWWDDDWWWFDDDDDDDDDDDDDDDDDDDDFIDDWWDDWDWWDDDDDFDDDDDDIDDDDDFDDDDIFDDDDDDDDDWWWDDDDDDDDDDDDDWWDD
DDDDFDWWDFDDWDDDMDDDFDWWDDDDDDDFDDDFDDDDDDWDDFDDDDDDDDDDDDDDDDWDWFDDDDDDDDDDDDWDMDFWFDDDDDDDDDDDDDDD
DDDDWDDDDDDDWFDDDDDFDDWWDDDDDDDWDDDDDDDWWWWDDDDDFDDDDDDWWDDDDFDDDDDIDDDDDDDWDDDIFDDDDDDDDDDDDDDDDDWW
DDDDIDDDDDWWWDDDDDDDDWDDDDDDDDDDDWWWDDDDDDDDDFWWWWFDGDDDDDDDDDDDDDDFWWWDDDDDDDDDDDDDDDDDDDDDDWWFDDDD
DWWDDDDDDDWDDDDDWWWFWWDWWFDFDDDDDDDDDDDDDDDDDDDDDDDDFDDDDDDDFWDDDDDWWDWWWDDDDIDDDDDDDDDDDDDDWDDDDDDW
DDDDDIDDDDMDDDDDDDFDFDDDDDDDDDDDDDDDDDWWWFMDDDDDFWWWWFWDDDDDFDDDDDDDDDDDWFDDDDDDDDDDWDFFDDDDDFIFDDDW
WDFDDDDDDDDDDDDDDDWDDDDDDDDFDDFDFDDDDDDDDDDDDDDDDWFDDDDDFDDDDDDDMDDDDDDDDDDDDDDDDDDWWDWWWDWDDDDDDGDD
DWWDWWFDDDDGDDWWDDDDDWWFDDFWWDDDWFDDDFDDDDDDDDDDDDDDDDDWWDDDDFDDDDDDDIDDDDFDFDDWDDWWDDDMFWWDDDDDDFDD
DDDDDDDWDDWDIDFDDDDDDDDDDDDDDDDWWWFDFDDDDDDDDDDDDDFDDDDDDDFWWDDDFWWWFDDDDWWFDDDDDWDDFGDFWDDWDDDDGDDD
DIDDWFDWWDWDFDDDDDDIDDDDWDDDDDDDDDDDDDWFDDDDDDIDDDDDDDDDFDDDFDDDDDDDDDDDDWWDDFIFDWWWDDDDDDDWDDDDDDDW
DDDDDDDMDFDDDDDDDDDDDFDDDDDIDDDFDDDDDDDDDDDDDDDDWWFDDDFDDDDDDDWDDDDDDDDDDDGFDDDDMDDDDDDDDDFDDFDIFDDW
DDFIDDDDWFDDDDDDDDDDDDFDDDDDWDDWWDDDDDDDDDDDDDDFDDFWFDWWDWDDDFWWWDDDDDDFDDFDDWFDDDDDFDDDDWDFDWDDDDDD
DDDDDWWWWDDDDDDFDDWDDDDFDDDDWWWWFDDDDDDDDDDDDWWDDDDDDGFWWDDDDDWWDDDFDDDWWDDDDWWDDDDWWFDDFDDGDWWWDMDD
DDDDDDDDDDDDDWWWDFWWDWDDGDIDDDDIFDWWWDFDDDDWWDWWFDDDDDDDFDDWWDWFDDWWDDDDDFDDDDDDDDDDDDDDDDDDDDDGDDDD
WDDDDDDDDFDFDDDDDMDDFWWWFDDIDWWDDDDDDDWDDDDDFDDDDDWDDDDDDDDWWFDDDDDDDWDDDDDFDDDDDFWDDDDDFDDDDDIDDDDD
DDDDDDDWDIFDFDDDDIDDWWDDDDDDDDDDWWDFDDDDGFDWWWDDFDDDDDDDDFDDMDDDDDFDDWWDDDFDDDFWWDDDDDDFDFDDDDDDDDID
WWFDDDDWFDDDWWDDDDDWDDWWDDDDDIDDDDDWDWDDDDDDDDDDDDDDDFWWDWDDFDDDDDWFFDIDDDDDWWWDDDDDDFDDFDDDFWDWWWDD
DDDDFDFWDWWDDDDDFDFDDFWDFDDDDDDDDDDWWFWWDDDDDDWDDDFDDIFDDDDDDDDDDFDDDDDDDDDDDDWWDDDDDDDFGDDDDWDDDDDD
DWDDDDDWDDDDDDDDDDDDDWWDWDDWDWWDDDWDDWDDDDWDDDWWDDWDDDDDWDDDDDWDDDDDDDDDDDWDDDDDWDDDDDWDDDDDDWDDDDDD