;Map made by Santella Agustin
;element index
;  D : Diert
;  M : Mountain
;  W : Water

; starting the level:
DDDDDDDWDDDDDDWWWDWWDWDDDDDWDDDDWDDDDDDDWDDWWDDDDDDDDDDDDWDDDDWDDWWDDDWDDWDDWDDDDDDWDDDDDDWDDDWDDDDD
DMDDFDDDDDDDDDDFDDDDMDFDFFDDDDDDDDDDDDDDDDDDDGDDDDDDDDDDIFDDDDDDDDIDDDDDDWWDWWDDDDDDDDIDDDDDDDGDIDDD
DDDDDDDDDDDDDDDDDDDMDFDDWWFDDDDDIDDDDDDDDDDDDDDDDDDDDFDDFDDDDDDIDDDDDDDDDDGDDDDFWFDDDDDDFDDDDFDDDDID
WFDDDDDDDDDDDDDFDDDDDDMDDDDDDDDDDDDDFDDGDFDDDDDDDDFDDDDDDDDDDDDDDFFDDDDDDDDDDDDWWWFDDDDFWWDDDDDDDDDD
DDDDDDFWWDDDIDDWWDDDWFDDDDDDDDDDDDDDWDWFWWDDDDDDIDDDDDIDDDIFDDDFDWWWDDDDFFDDDDMDDDDDDDFDDDDDDDDDFFDD
WFDDDFWWDDFDDDDDDFFWWWFDFDDDGDDDDDDWWDWFDDDDDDDDDDDDDDDDDDDWWWWWDDDDDDDFWWFDWFDFDDDIDDWWDDDMDDDDWWWD
DDDDDDDDWDWDDMDDDWWWFDDWWFFDDDDDDMFDDWWDDDDDDGDDDDGDDDDWWWFDDWWDDFDDDDFWWDDDWDDDDDDDDDDDDDDDDDDDDDDD
DDIDDDDWWWWWWDDDDDDDDIFIDFDDDDDDFDWFWWDDDDDFDDDDDFDDDFDDFDDDFWDDFDDDDDDIDDDFWWWFDDDDDDDDDDDIDDDDDDDD
DDMDDDIDDFDDDDDMDDDGDFDDWWDFDDDWWWWWWFDDDDDWWWDDDWWDFDDFDMIDWWDDDDDDDDDDDDDDDDDDDDDFWWWFDDDFIDDDDDFD
DDDDDDDDDDDDDDDDDDDFDDDGFWWWDDDDDDDDDIFDDDDDDGDDFDFWWDDDDDDDWDDDDDDDDDDDDDDDDDDDDDMDMDDDDWWWDDDDDDWW
WWDDGDDDDDFDDDDDFDWWWWDDDIDDDDDDFDDDDDDDDDDDDDDDDDDDGDDDDDDDWDDMDDDDFDDDDDFDDDDWFDMDDDDDDDDDDDDDDDDD
DFDDDDDDDDWWWDWWWFDDDDDDDDMDDDDFDDDDDDDDDDDDDDDDDDDDDDWDDDFWWDIDWDDDDDDDDDWWDDWWDFFDDDDDDDDDDDFWDDDD
DWWFDDDDDDDDFDDDDDDDIFDDDDDDDDDDDMDDWWDWWDDDDDDDDWWDDDDDDDDDDDDWWFDFDDDDDFDDIDDDDWWWDMDMDDDDDDWWDDDD
DDDDIFDDDDDDDDIFDDDDDDDWWDDDDDWWDDDDDDDDDDFDDDDDDDDDFDDDDDDDDDDDGDIDIDDDDWWDDIDDDFDDDDIDDDDDDWWFFDDD
DWWDDDDDDDDDDDDDDDDDDDDDDDDDDDDDDFWWDDDDDFDDDDDIDWFDDDDDDDWWDDDDFDDFDDDDDDDDDFWWFDDDGDDDDDDDDDDDWFDD
DDDDDFWWDDGDDDDDDGDDDDDDDDDDDDDDDDDDDDDDDDDDDFWDFWWDDDDDDDDDDDDDWWDWWDDDDDDDWWFDDDDDDDDDDDWFGFDDWDWW
DDDDDDDDDDDFWWWDDDDDDDDDDDFDDDDDDDFDDDWDDDDDDDWWFFDDDDDDDFDDWDFWWDDDDFDDDFDDDDDMDDDIDWDDDWWWDDFWWWWD
DDDDDFWDDDMDDFWWDFFDDDDDDFDDDDFGDDWDDFWWWFWWFIDDFWWFDDDDWWFDWWDDMDDDDDDDFWWFDDDDDDDDWWDDFDFWWWDDDDDD
DDDDDDWWDDDDDDDDFWWWDDDDDDDDDFWDDDWWDDDDDDDDDDMDDDDDDFWWWDFDFDDDDDWWWFDDDDDDDGFWDDDDDDDWWDDFWWDDWWDD
DDDDWWFDDDDDDDDDFWWWWDDDDDDDDFWWFDIFDDDDDDFDDDDDDFDDDDDDDFWFWDIDDFWDWWFDDMDDDFWWWFDDWFDDDDDWWWFDIDFW
WWFDDDDDDDDDDDDDDDFWWDDDDDDDDDDDFDDDDDDDDDDDDMMMDDDDDDDDFDWWWDDWWWWDDDFDDDGDDDDDFWWDDDDGDDWFDDDDDDFW
DDDDDDDDDFDDWWFDDDDDDDDDDDDDDDDFWFDDWWWFDDDDDMDDDDMDDDFWWFDDDDDDDDDDDDFDDDDDDDDDDDDDGDDFDDDDDDDDDDDD
WDIFDDDDDWDDDDDDDDDDDDDDDDDDDDDDDDDFWWDDDDDDDDDDDFDDDDDDDDDDDDDDDDDDDDWWFDDDDDDDDDDWDDDWWDFDDMDDFDDD
DDDDDDDDFDIDDDDDDDDDDDDDMDWDDWWDDDWWWDDDDDFDDDDWWWWFDDDDDDDDDDDDDDIFFDDFWWWDDDDDDDDDFDDFDWWDDDIFDDDD
DDDDDDDDDFDDFWWDDDDDDDWWFDWDWWDDDDWWWDDDFWWDMDDDDDDDDDFDDGDDDFWWDDDDWDDDDDDDDDDDDDDDIFDWWFDDDDDDDDDD
DDWWFDDDFWWFFDFDDDDDDDDWWWWFDDDDDDDDDDDDDDDDDDDDDFWWDDDDDDDIFDDFDDDDWWDDIFDDFFWDDDDDDDDDFFDDDDDDDDDD
WDDDDDDDDDFWWDGFDDDDDDDDWWDDDDDWFMDDDDWWDFWFWDDDWDWDDDIDDDDDDGDDDFWWDDDDDDDFWWWDIFFDDDDFWWDDDIFDDDDD
DDDDDDFDDDDDDDDDDDIDDDDDWWWFDDDWWDDDDDDDDWWWWDDWWWWWDDDDMDDDDFDDDDDDDDIDDDDDDFDDDDDDDFWWWWWDDDDDFDWW
WDDDDDDDDDDDDDDDDDFDDDDWDDDDDDDDDGFFDDDDDDDDDDDDDDDWWWDDDDDDFWDDDDDDDDDMDDDDDDDDDWDDDDDDDDDDDDDFWFDD
DFDDDDDDDDFWDDDDDWWDWWWWWDDDDDDDDDDDDDDDDDDDDDDDDDDDDDDDDDDDDWWFDDDDDDDDDDDDIDDDWWFDDIDDDDDDDDDDWWDD
DDDDDDFWWDWWDDIFDDDDDDFWDWWDDDDFDDDDDDDDDDDDFIDDDGDDDFDWWFDDWWDDDDDDDFWDDDDDDWDDDFWWDDDIDDDDDDDDDDDW
WDDDDDDDDDDDDDDDDDDDDDFWWDDDDFDDDDDDDWFFDDDDDDDFDDDDDWFDDWWDDDDDDDDDDWWDDDDDDWWDDWDDDDDDDDDDDDDDFFDD
DDDDDMDDDDDDDIDDMDDDDWWDFWWDWWDDFDDDDWWWDDDDDDDWWDDDWWDDFDDDDDDWDDDFDDDDDDDDDFDFWWFDDDDDDDDDIDDDWWDW
DDMDDDDDDDDDDFDDIDDDDFDDIDDDDDDDDDIFDDDDDDDDDDWFDDDDDDFFDDDDDDDWWDWWDDDDDDFFDDDDDDDDDDDFFWDDDDDDDFDD
DIDDDWWDWWDDFDDDDDDDDDDDDDDFWFDDDDDDIDDDDDWWDDDDDMDFDDWFDDDDDDDFWWDDDDDDFFWWDDGDDDDDDDDWWWFDDDDDDWWD
DDFMDDDDWDDDDDFDDFWWFDDDDWFDWWDDDDDDDDFWDDDWDDDDDDFDDDWWFDWWFDDDDDDDFDDDDDFDDGDDDDDDDDDDDDDDDDDDDDDD
WFDDDDDWWWDWWDWWDDDWWDDFFWWDDDDDDDDFDDWWDDDWWDDDDDDDDWWDDDDDDDDDDDDDDFWWDDDDDDDIFDDDDDDDMDDFWWDDDDFW
DDDDDDDDDDDDDDDDWDDFDFWWWWDDDFWWDDDDDDDDDDDDDDDDDDDDDDDDFWDDDDDDDDDDDDIFDDDDDDDGDDDIFDDDDFDDIDDDDIDD
DDGDDDDDDDDDDDDDWFWWDDDDDIFDDDWWDDDDDDDDDDDDDDDDDDFDDDDDWWDDDDDDIDDDGDDDDFWFFDDDWWFDDDWWFDDDDDDFDDDD
WFDDDDDFDFFDDDDFWWFDDDDDDDDDDDDDDDDDDDDDDFDDDDDFWDDDDDDDDDDDDDDDFWDDFDDDDDWWWWDDDDDDDDDDDDDDWWDWWDDD
WWDDDDDDFWWDDWWFDFWWDDDDDDDDMIDDWWDWWFIFDDDDDDDFDDWWDDMDDDDFWWFDWWDDWWDDDDDWWDDDWWDDDDDDDDWFDGDDDDDD
DDDDDDDDFFWWDDDDDDDDDDDDDDDFDDWWDDDDWWFDDFDDDFDDDDDDDDFDWDDDDDDDDDFDDWWWDWWDDDDDDDIDDDDIFDWWWFGDDDDD
DDDDDDDDWFDDDDDDDDDDDDDDDDDWDDDDDDDDDDDDDIDDFWDDDDDDDDDDDDDDDDDDDDDDDDDWFDDDDDDDWDDDDDDDDIDDDDDDIDDD
WFIDDDDWWDDWWDDDDDDDDDDDDFWWDDDGDDDDDDDDDDFDWWDDDDDDDFDDDDDDDFDGFDDDFFDWDDDDDDDDDDDDDDWWDIDDDDDIFDWD
WDDDDFDDDFDIDDFDWWDDDDDDDDDFDDDDDDDDMDDDWWWDDDDDDDDDFWFDDDDDDWWDDDDDWWDWWWDDDDDDDDDDDDDDDDDDDDFDDDWW
DDDDDWWDFDDDDDWWWFDWDDDDDDDDDDDDDDDDDDFDDDDDDDIDDDDDWWDDDMDDDGDDFDDDFDDDFDDDDDDDDDDDDDDDDDDDDWWFDFDW
DDDDDDDDDDDDDDDIFDDDDDDDDDDDDDDDDDDDDDDDDDIDDDDDDDDDDDDDDFDDDDDDWWDDDDFDDDDDDDDDDDDDDDDDDDDWWFDDDWDD
DDFDWDDDDDDFDDDDIDDDDDWWFDDDDDDDDDDDDMDDIDDDDDFWWDDDDDFIDDDDDFDDDDIDDFMDDDDDDDDDDDDDDDDDDDDDDDDDFDFD
WFWWWFDWWDDWWFFDDFDDDDFWFDWFDDDDDDDDDDDDDIDDDDGMDFDDDWWFDDGDDWWFDDDDDDDDDDDDFDDDDDDDDDDDDIDDDDDDDDWW
DGDDDDDDDDDDDDDDFDDDDIDWWDWWFDDDDDWDDDMDDDDDDDDDDWDDDDDDFDDDDDDWFDDDDDFWWDDDDFWDFIDDDDDDDDDDDDDWFDDD
WFDDDDDDWDDDDDDDDDDDDDDDDDDFDDDDDWWDDDDWWFDFWWDDDWWDDDDDDDDDDFDWDDDDDDDDWDDDDDWWWFDDDDDDWWDDFWDDDDDD
WWDDDDDDWDDFDDDDFMDDDDDDIFDWDDDDFDDDDDWDDDDDDDDDFWWFDDDDMDDIFWDWWWDDDDIDWWDIDDDDDDDDDIDDDDDWWWDDIDDD
DDDDDWDDWDDWWWDWWDDDDFFDDDFWWDWWWDDDDWWDDDFDDDDDDDDDFDDDDDDDDWWDDGDDDFDDDDDDDDDFWWDDDDFDDFWDWDDDDDDD
DDFDDWWFWWFDDIDDDDDDDWWDDFDDDDDDDDDDDDDDDDWWFDDDFDDDDGFDDDDDDDDDDDDFWWDDDDDDDDDDWWFDDMDDDFDDDDDDDDFW
DDWDDFDFDFDDDFDDDDDDDDDDDDDDDFDDDDDDWWWDDDDDDDGDDDDDDDDDDDDDDDDDDDDDDDDDDDDDDDDFWFDWWDDDDDDDDDDDDDDD
WDWWFFDDFWDDDWDFDDDDDDDDDDDDDMMDDDDDDDDDFDDDDDDDDDDIFDFDDDFDDDDDDDDDDDDDDDDDDDDDDWWWDDDDDDDDDFWDDDFW
WDIFFWDDDWDDFWWWDDDDDDDDDDDDMDDDDDDDFDDDFDDWWDDDDIFFDDWDDFWWDDDDDDMDDDDDDDDDDDDDDDFWWFDDMDDDDWWDDDDD
DDDFWWDWWDDDDDDDDDDDDFDDDDWFDDDDDDDDWWDWWDDDDDFDDDWWFDDMDDFWWFDIDDDDDDDDDDDDDDDDMDDDDDMDDDDFDDDDDDDD
WFDIMIDFWWDFFDDDFWWFWWDWWWWDDDDDDDDDDIDDDDDDDDDDDDDDDFDDDDDDDIFDDDDDDDDDDDDDDDDDDFFDDDDWWFDDFWWWFDDD
WDDDDFDDDDFWWWDDDDDDDDDDDDDDDDDDDDDDDDDDDDDDFDFDDDDFDDDDDDDDDDDDDDDDDDWWDDWWDDDDFWWDDFDFDDDDDDWWDDDD
DDDDDDDDIFDDDDDDDDDDDDFWWFDMDDDDDFWWFFDDDDIDDFDDDDDWFFDDDDDDDDDDDDDDDDDDFDDDDDDDDDDDWWFWWDDDDDDFDDDD
DIDFDDDDDDDDDDDDDWWDDFDIDFWFDDDDDDDDDDDDDDDDDDDDDIDWWWDDDDIDDDWWFDDDDDDDDDDDDMDDFDDDDDWWDDDDIDDDDDWW
DFDWDFDDDFDIDWDDDIDDFDDDDFWWWFMDDDDDDIDDDDDFDDDDDFWWDDDDDDDDDDDDDDDDDDDDDDDDDDDFWWFDDDDDDDDDDWWDDDDD
DWFWWWFIDDDDDWWFDDDDDDDDDDGDDDDDDGDDDDDDDDWWDDDFWWFDDDDDDFWFDDDDDDDDDDDDDDDDDDDFDDDDDFDDFDDDDDDDDDDW
WWFDFDDDDDDDDDDIDDDDDDWWDDDDDGFDDDDDDDDDDDDDDDDIDFWWFDIFDDWWDDDDDDDDDDDDDDDDDDDDDDDWFDDFWWDDDDIDDDDD
DDDDDDDDDDDDDDDDDDDDDDDDDDDDDIDDDDDDDDFDDWWDDDDDDDDDFDDDDDDDDDDDDDDDDDDIDDIDDFDDDDWWFDDDDDDDDDDDDDDD
WDWDDDDDDDDDDDDWDDDDDDDDMFWWFDIFDDDDWFWDDDDDDDDIDDDDDDDDDDDMDDDDDFFFDDDDIDDDDDDDDDDDDFWDDDDIDDDDDDDD
WWWDDDDDDDWDDFDWWDMDDDFFDDWWWFDDDDDDWWWFDDDDDDDDWWDDDDDDDMDDFWWFDWWWDFDDDDDDDDDDDDMDDWWFDDDFDDDDDDDD
DDDDDDDDDDDDDDDDWWDDDDWWWDDDDMDDDDDFWWDDDDDWWFDDGDDDDDDDDDDDDDMDIDDDFIFIDDDDDDDDIMDDDDDDDFWWDDDMDDDD
DFWWDDDDDDDDDDDDDDDMDDDDDDDDDDDDIDDDDDDDDFFFFWWDDDDDDDDDDDDDDDDDDDDMDDDDDWWDDDDDDDDDDDIFDFWWFDDDDDDD
DDFDDDDDDDDDDDDDFMDDDMDDDDDDDDDDDWFDDDDDDWWWDDDMDDDFDDDDDDDDDDDDDDDDDDDDDMDDDMDDWWDMDDFWFDDDDDDDDDDD
DDDDDDDDDDFDDDDDDDDDDDDDDWWFDDDDDWWDDDDDDDDDDDDDDGDDDDDMDDDDDDFDDDDDDMFFDDFFDDDDDDDDDDDWWFDDDDDDDDDD
DIDDDDDDDWWDDDIDDDDDDDDDDDDMIFMFWDDDDDFIDDDDWWDDGFDDDDDFDFDDDFWDDDFWDDWWFDWDDDDDDMDDDDFWDDDDDDDDFDDD
WDDDFWWDGFFDDDDDDDDDFDDDDDDDDDDFWWFDDFDDDDDFWFWFDDDDWDDDFWDDFWWDDFWWFDDFDDWWDDDDDDDDFDDWWWFDIDDDWWDD
DDDDDFWWFDWWDDDDDDFDDDDDDDDDMDDDDDDDDDDDDFFFWWWWWDDFWWDDFWWWDDDWWWWDDDWWDWWWFDDDDDDDDDDDMDFDDDDDDDDD
DDDDDDDDDDDDDDDDWWWDDDFDDFFDDMDDDDDDDDDDFWWDMDDDDDDDDDDDDDDDDDDDWWDMDWDFDDDDDDDDDDDDDDDDDDDDDFGDDDGD
DDDDDDDDDDDDDDGDDDIFDDDDWWWDDDDDDDDDDDDDIDDDDDFDDDDDDDDDDDWFDDDDIDDDFWWWFDDDDDDDDDDDDDDMDDDFWWFDDDDD
DDDDDDFWWDIDDDDWDDIDDDDDDDDIFDDFDDDDDWWDDDDDDDDDDDDDDDDDFDWDWWFDFDDDDDWWWDDDDDDDDFDDDDDFWWDGDDDWWWWD
DDDDDDDDDDIDDWWWDDDFDDDDDDDDDDDDDDFDDDDDDDDDDDDDMDWDDDWDDDWWDDGDDDDDWWDDDDFDDDDDDWWDWFFDDDDDDDDDDIDD
DDDDDDDDWDDDDDDDWDDWDDDDWDDDDDWDDDWDDDWWDDWDDDWDDWWWDDWDDDWDDDDDDWDDDWDDDDWDDDDDWWDDWDWDDDDDDDDDDDDW