;Wapa hecho por Ian Sanna
;Los eleWentos en el Wapa corresponden de la siguiente Wanera
;  D: Valle
;  M: Wontaña
;  W: War

; EWpezando el nivel:
MMMMMMMMMMMMMMMMMMMMMMMMMMMMMMMMMMMMMMMMMMMMMMMMMMMMMMMMMMMMMMMMMMMMMMMMMMMMMMMMDDDDDDDDDDDDDDDDDDDDDDDDDDDDDDDDDDDDDDDDDDDDDDDDDDDDDDDDDDDDDDDDDDDDDDDDDDDDDDDDDDDDDDDD
MDDDDDDDDWWWWDDDDDDDDDDDDDDDDDDDDDDDDDDMMDDDDDDDDWWWWDDDDDDDDDDDDDDDDDDDDDDDDDDMDDDDDDDDDDDDDDDDDDDDDDDDDDDDDDDDDDDDDDDDDDDDDDDDDDDDDDDDDDDDDDDDDDDDDDDDDDDDDDDDDDDDDDDD
MDDDDDDDDDDDDDDDDDDDDDDDDDDDDDDDDDDDDDDMMDDDDDDDDWWWWDDDDDDDDDDDDDDDDDDDDDDDDDDMDDDDDDDDDDDDDDDDDDDDDDDDDDDDDDDDDDDDDDDDDDDDDDDDDDDDDDDDDDDDDDDDDDDDDDDDDDDDDDDDDDDDDDDD
MDDDDDDDDDDDDDDDDDDDDDDDDDDDDDDDDDDDDDDMMDDDDDDDDWWWWDDDDDDDDDDDDDDDDDDDDDDDDDDMDDDDDDDDDDDDDDDDDDDDDDDDDDDDDDDDDDDDDDDDDDDDDDDDDDDDDDDDDDDDDDDDDDDDDDDDDDDDDDDDDDDDDDDD
MDDDDDDDDDDDDDDDDDDDDDDDDDDDDDDDDDDDDDDMMDDDDDDDDWWWWDDDDDDDDDDDDDDDDDDDDDDDDDDMDDDDDDDDDDDDDDDDDDDDDDDDDDDDDDDDDDDDDDDDDDDDDDDDDDDDDDDDDDDDDDDDDDDDDDDDDDDDDDDDDDDDDDDD
MDDDDDDDDDDDDDDDDDDDDDDDDDDDDDDDDDDDDDDMMDDDDDDDDWWWWDDDDDDDDDDDDDDDDDDDDDDDDDDMDDDDDDDDDDDDDDDDDDDDDDDDDDDDDDDDDDDDDDDDDDDDDDDDDDDDDDDDDDDDDDDDDDDDDDDDDDDDDDDDDDDDDDDD
MDDDDDDDDDDDDDDDDDDDDDWWWWDDDDDDDDDDDDDMMDDDDDDDDWWWWDDDDDDDDDDDDDDDDDDDDDDDDDDMDDDDDDDDDDDDDDDDDDDDDDDDDDDDDDDDDDDDDDDDDDDDDDDDDDDDDDDDDDDDDDDDDDDDDDDDDDDDDDDDDDDDDDDD
MDDDDDDDDDDDDDDDDDDDDDWWWWDDDDDDDDDDDDDMMDDDDDDDDWWWWDDDDDDDDDDDDDDDDDDDDDDDDDDMDDDDDDDDDDDDDDDDDDDDDDDDDDDDDDDDDDDDDDDDDDDDDDDDDDDDDDDDDDDDDDDDDDDDDDDDDDDDDDDDDDDDDDDD
MMMMMDDDDDMMMMMMMMMMMMMMMMMMMMMMMMMMMMMMMDDDDDDDDWWWWDDDDDDDDDDDDDDDDDDDDDDDDDDMDDDDDDDDDDDDDDDDDDDDDDDDDDDDDDDDDDDDDDDDDDDDDDDDDDDDDDDDDDDDDDDDDDDDDDDDDDDDDDDDDDDDDDDD
MMMMMDDDDDMMMMMMMMMMMMMMMMMMMMMMMMMMMMMMMDDDDDDDDWWWWDDDDDDDDDDDDDDDDDDDDDDDDDDMDDDDDDDDDDDDDDDDDDDDDDDDDDDDDDDDDDDDDDDDDDDDDDDDDDDDDDDDDDDDDDDDDDDDDDDDDDDDDDDDDDDDDDDD
MMMMMDDDDDMMMMMMMMMMMMMMMMMMMMMMMMMMMMMMMDDDDDDDDWWWWDDDDDDDDDDDDDDDDDDDDDDDDDDMDDDDDDDDDDDDDDDDDDDDDDDDDDDDDDDDDDDDDDDDDDDDDDDDDDDDDDDDDDDDDDDDDDDDDDDDDDDDDDDDDDDDDDDD
MMMMMDDDDDMMMMMMMMMMMMMMMMMMMMMMMMMMMMMMMDDDDDDDDWWWWDDDDDDDDDDDDDDDDDDDDDDDDDDMDDDDDDDDDDDDDDDDDDDDDDDDDDDDDDDDDDDDDDDDDDDDDDDDDDDDDDDDDDDDDDDDDDDDDDDDDDDDDDDDDDDDDDDD
MMMMMDDDDDMMMMMMMMMMMMMMMMMMMMMMMMMMMMMMMDDDDDDDDWWWWDDDDDDDDDDDDDDDDDDDDDDDDDDMDDDDDDDDDDDDDDDDDDDDDDDDDDDDDDDDDDDDDDDDDDDDDDDDDDDDDDDDDDDDDDDDDDDDDDDDDDDDDDDDDDDDDDDD
MDDDDDDDDDDDDDDDDDDDDDDDDDDDDDDDDDDDDDDMMDDDDDDDDWWWWDDDDDDDDDDDDDDDDDDDDDDDDDDMDDDDDDDDDDDDDDDDDDDDDDDDDDDDDDDDDDDDDDDDDDDDDDDDDDDDDDDDDDDDDDDDDDDDDDDDDDDDDDDDDDDDDDDD
MDWWWWDDDDDDDDDDDDDDDDDDDDDDDDDDDDDDDDDMMDDDDDDDDWWWWDDDDDDDDDDDDDDDDDDDDDDDDDDMDDDDDDDDDDDDDDDDDDDDDDDDDDDDDDDDDDDDDDDDDDDDDDDDDDDDDDDDDDDDDDDDDDDDDDDDDDDDDDDDDDDDDDDD
MDWWWWDDDDDDDDDDDDDDDDDDDDDDDDDDDDDDDDDMMDDDDDDWWWWWWWWWDDDDDDDDDDDDDDDDDDDDDDDMDDDDDDDDDDDDDDDDDDDDDDDDDDDDDDDDDDDDDDDDDDDDDDDDDDDDDDDDDDDDDDDDDDDDDDDDDDDDDDDDDDDDDDDD
MDWWWWDDDDDDDDDDDDDDDDDDDDDDDDDDDDDDDDDMMDDDDDWWWWWWWWWWWWDDDDDDDDDDDDDDDDDDDDDMDDDDDDDDDDDDDDDDDDDDDDDDDDDDDDDDDDDDDDDDDDDDDDDDDDDDDDDDDDDDDDDDDDDDDDDDDDDDDDDDDDDDDDDD
MDDDDDDDDDDDDDDDDDDDDDDDDDDDDDDDDDDDDDDMMDDDDDDDDWWWWDDDDDDDDDDDDDDDDDDDDDDDDDDMDDDDDDDDDDDDDDDDDDDDDDDDDDDDDDDDDDDDDDDDDDDDDDDDDDDDDDDDDDDDDDDDDDDDDDDDDDDDDDDDDDDDDDDD
MDDDDDDDDDDDDDDDDDDDDDDDDDDDDDDDDDDDDDDMMDDDDDDDDWWWWDDDDDDDDDDDDDDDDDDDDDDDDDDMDDDDDDDDDDDDDDDDDDDDDDDDDDDDDDDDDDDDDDDDDDDDDDDDDDDDDDDDDDDDDDDDDDDDDDDDDDDDDDDDDDDDDDDD
MDDDDDDDDDDDDDDDDDDDDDDWWWWDDDDDDDDDDDDMMDDDDDDDDWWWWDDDDDDDDDDDDDDDDDDDDDDDDDDMDDDDDDDDDDDDDDDDDDDDDDDDDDDDDDDDDDDDDDDDDDDDDDDDDDDDDDDDDDDDDDDDDDDDDDDDDDDDDDDDDDDDDDDD
MDDDDDDDDDDDDDDDDDDDDDDWWWWWWWWDDDDDDDDMMDDDDDDDDWWWWDDDDDDDDDDDDDDDDDDDDDDDDDDMDDDDDDDDDDDDDDDDDDDDDDDDDDDDDDDDDDDDDDDDDDDDDDDDDDDDDDDDDDDDDDDDDDDDDDDDDDDDDDDDDDDDDDDD
MDDDDDDDDDDDDDDDDDDDDDDWWWWWWWWDDDDDDDDMMDDDDDDDDDDDDDDDDDDDDDDDDDDDDDDDDDDDDDDMDDDDDDDDDDDDDDDDDDDDDDDDDDDDDDDDDDDDDDDDDDDDDDDDDDDDDDDDDDDDDDDDDDDDDDDDDDDDDDDDDDDDDDDD
MDDDDDDDDDDDDDDDDDDDDDDWWWWDDDDDDDDDDDDMMDDDDDDDDDDDDDDDDDDDDDDDDDDDDDDDDDDDDDDMDDDDDDDDDDDDDDDDDDDDDDDDDDDDDDDDDDDDDDDDDDDDDDDDDDDDDDDDDDDDDDDDDDDDDDDDDDDDDDDDDDDDDDDD
MDDDDDDDDDDDDDDDDDDDDDDDDDDDDDDDDDDDDDDMMDDDDDDDDDDDDDDDDDDDDDDDDDDDDDDDDDDDDDDMDDDDDDDDDDDDDDDDDDDDDDDDDDDDDDDDDDDDDDDDDDDDDDDDDDDDDDDDDDDDDDDDDDDDDDDDDDDDDDDDDDDDDDDD
MMMMMMMMMMMMMMMMMMMDDDMMMMMMMMMMMMMMMMMMMDDDDDDDDDDDDDDDDDDDDDDDDDDDDDDDDDDDDDDMDDDDDDDDDDDDDDDDDDDDDDDDDDDDDDDDDDDDDDDDDDDDDDDDDDDDDDDDDDDDDDDDDDDDDDDDDDDDDDDDDDDDDDDD
MMMMMMMMMMMMMMMMMMMDDDMMMMMMMMMMMMMMMMMMMDDDDDDDDDDDDDDDDDDDDDDDDDDDDDDDDDDDDDDMDDDDDDDDDDDDDDDDDDDDDDDDDDDDDDDDDDDDDDDDDDDDDDDDDDDDDDDDDDDDDDDDDDDDDDDDDDDDDDDDDDDDDDDD
MDDDDDDDDDDDDDDDDDDDDDDDDDDDDDDDDDDDDDDMMDDDDDDDDDDDDDDDDDDDDDDDDDDDDDDDDDDDDDDMDDDDDDDDDDDDDDDDDDDDDDDDDDDDDDDDDDDDDDDDDDDDDDDDDDDDDDDDDDDDDDDDDDDDDDDDDDDDDDDDDDDDDDDD
MDWWWWDDDDDDDDDDDDDDDDDDDDDDDDDDDDDDDDDMMWWWWWWWWWWWWWWWWWWWWDDDDDDDDDDDDDDDDDDMDDDDDDDDDDDDDDDDDDDDDDDDDDDDDDDDDDDDDDDDDDDDDDDDDDDDDDDDDDDDDDDDDDDDDDDDDDDDDDDDDDDDDDDD
MDWWWWDDDDDDDDDDDDDDDDDDDDDDDDDDDDDDDDDMMWWWWWWWWWWWWWWWWWWWWDDDDDDDDDDDDDDDDDDMDDDDDDDDDDDDDDDDDDDDDDDDDDDDDDDDDDDDDDDDDDDDDDDDDDDDDDDDDDDDDDDDDDDDDDDDDDDDDDDDDDDDDDDD
MDWWWWDDDDDDDDDDDDDDDDDDDDDDDDDDDDDDDDDMMWWWWWWWWDDDDDDDDDDDDDDDDDDDDDDDDDDDDDDMDDDDDDDDDDDDDDDDDDDDDDDDDDDDDDDDDDDDDDDDDDDDDDDDDDDDDDDDDDDDDDDDDDDDDDDDDDDDDDDDDDDDDDDD
MDDDDDDDDDDDDDDDDDDDDDDDDDDDDDDDDDDDDDDMMDDDDDDDDDDDDDDDDDDDDDDDDDDDDDDDDDDDDDDMDDDDDDDDDDDDDDDDDDDDDDDDDDDDDDDDDDDDDDDDDDDDDDDDDDDDDDDDDDDDDDDDDDDDDDDDDDDDDDDDDDDDDDDD
MDDDDDDDDDDDDDDDDDDDDDDDDDDDDDDDDDDDDDDDDDDDDDDDDDDDDDDDDDDDDDDDDDDDDDDDDDDDDDDMDDDDDDDDDDDDDDDDDDDDDDDDDDDDDDDDDDDDDDDDDDDDDDDDDDDDDDDDDDDDDDDDDDDDDDDDDDDDDDDDDDDDDDDD
MDDDDDDDDDDDDDDDDDDDDDDWWWWDDDDDDDDDDDDDDDDDDDDDDDDDDDDDDDDDDDDDDDDDDDDDDDDDDDDMDDDDDDDDDDDDDDDDDDDDDDDDDDDDDDDDDDDDDDDDDDDDDDDDDDDDDDDDDDDDDDDDDDDDDDDDDDDDDDDDDDDDDDDD
MDDDDDDDDDDDDDDDDDDDDDDWWWWWWWWDDDDDDDDMMDDDDDDDDWWWWDDDDDDDDDDDDDDDDDDDDDDDDDDMDDDDDDDDDDDDDDDDDDDDDDDDDDDDDDDDDDDDDDDDDDDDDDDDDDDDDDDDDDDDDDDDDDDDDDDDDDDDDDDDDDDDDDDD
MDDDDDDDDDDDDDDDDDDDDDDWWWWWWWWDDDDDDDDMMDDDDDDDDWWWWDDDDDDDDDDDDDDDDDDDDDDDDDDMDDDDDDDDDDDDDDDDDDDDDDDDDDDDDDDDDDDDDDDDDDDDDDDDDDDDDDDDDDDDDDDDDDDDDDDDDDDDDDDDDDDDDDDD
MDDDDDDDDDDDDDDDDDDDDDDWWWWDDDDDDDDDDDDMMDDDDDDDDWWWWDDDDDDDDDDDDDDDDDDDDDDDDDDMDDDDDDDDDDDDDDDDDDDDDDDDDDDDDDDDDDDDDDDDDDDDDDDDDDDDDDDDDDDDDDDDDDDDDDDDDDDDDDDDDDDDDDDD
MDDDDDDDDDDDDDDDDDDDDDDDDDDDDDDDDDDDDDDMMDDDDDDDDWWWWDDDDDDDDDDDDDDDDDDDDDDDDDDMDDDDDDDDDDDDDDDDDDDDDDDDDDDDDDDDDDDDDDDDDDDDDDDDDDDDDDDDDDDDDDDDDDDDDDDDDDDDDDDDDDDDDDDD
MMMMMMMMMMMMMMMMMMMMMMMMMMMMMMMMMMMMMMMMMMMMMMMMMMMMMMMMMMMMMMMMMMMMMMMMMMMMMMMMDDDDDDDDDDDDDDDDDDDDDDDDDDDDDDDDDDDDDDDDDDDDDDDDDDDDDDDDDDDDDDDDDDDDDDDDDDDDDDDDDDDDDDDD
MDDDDDDDDDDDDDDDDDDDDDDDDDDDDDDDDDDDDDDMMDDDDDDDDDDDDDDDDDDDDDDDDDDDDDDDDDDDDDDMDDDDDDDDDDDDDDDDDDDDDDDDDDDDDDDDDDDDDDDDDDDDDDDDDDDDDDDDDDDDDDDDDDDDDDDDDDDDDDDDDDDDDDDD
MDDDDDDDDDDDDDDDDDDDDDDDDDDDDDDDDDDDDDDDDDDDDDDDDDDDDDDDDDDDDDDDDDDDDDDDDDDDDDDMDDDDDDDDDDDDDDDDDDDDDDDDDDDDDDDDDDDDDDDDDDDDDDDDDDDDDDDDDDDDDDDDDDDDDDDDDDDDDDDDDDDDDDDD
MDDDDDDDDDDDDDDDDDDDDDDWWWWDDDDDDDDDDDDDDDDDDDDDDDDDDDDDDDDDDDDDDDDDDDDDDDDDDDDMDDDDDDDDDDDDDDDDDDDDDDDDDDDDDDDDDDDDDDDDDDDDDDDDDDDDDDDDDDDDDDDDDDDDDDDDDDDDDDDDDDDDDDDD
MDDDDDDDDDDDDDDDDDDDDDDWWWWWWWWDDDDDDDDMMDDDDDDDDWWWWDDDDDDDDDDDDDDDDDDDDDDDDDDMDDDDDDDDDDDDDDDDDDDDDDDDDDDDDDDDDDDDDDDDDDDDDDDDDDDDDDDDDDDDDDDDDDDDDDDDDDDDDDDDDDDDDDDD
MDDDDDDDDDDDDDDDDDDDDDDWWWWWWWWDDDDDDDDMMDDDDDDDDWWWWDDDDDDDDDDDDDDDDDDDDDDDDDDMDDDDDDDDDDDDDDDDDDDDDDDDDDDDDDDDDDDDDDDDDDDDDDDDDDDDDDDDDDDDDDDDDDDDDDDDDDDDDDDDDDDDDDDD
MDDDDDDDDDDDDDDDDDDDDDDWWWWDDDDDDDDDDDDMMDDDDDDDDWWWWDDDDDDDDDDDDDDDDDDDDDDDDDDMDDDDDDDDDDDDDDDDDDDDDDDDDDDDDDDDDDDDDDDDDDDDDDDDDDDDDDDDDDDDDDDDDDDDDDDDDDDDDDDDDDDDDDDD
MDDDDDDDDDDDDDDDDDDDDDDDDDDDDDDDDDDDDDDMMDDDDDDDDWWWWDDDDDDDDDDDDDDDDDDDDDDDDDDMDDDDDDDDDDDDDDDDDDDDDDDDDDDDDDDDDDDDDDDDDDDDDDDDDDDDDDDDDDDDDDDDDDDDDDDDDDDDDDDDDDDDDDDD
MMMMMMMMMMMMMMMMMMMMMMMMMMMMMMMMMMMMMMMMMMMMMMMMMMMMMMMMMMMMMMMMMMMMMMMMMMMMMMMMDDDDDDDDDDDDDDDDDDDDDDDDDDDDDDDDDDDDDDDDDDDDDDDDDDDDDDDDDDDDDDDDDDDDDDDDDDDDDDDDDDDDDDDD
MDDDDDDDDDDDDDDDDDDDDDDDDDDDDDDDDDDDDDDMMDDDDDDDDDDDDDDDDDDDDDDDDDDDDDDDDDDDDDDMDDDDDDDDDDDDDDDDDDDDDDDDDDDDDDDDDDDDDDDDDDDDDDDDDDDDDDDDDDDDDDDDDDDDDDDDDDDDDDDDDDDDDDDD
MDDDDDDDDDDDDDDDDDDDDDDDDDDDDDDDDDDDDDDDDDDDDDDDDDDDDDDDDDDDDDDDDDDDDDDDDDDDDDDMDDDDDDDDDDDDDDDDDDDDDDDDDDDDDDDDDDDDDDDDDDDDDDDDDDDDDDDDDDDDDDDDDDDDDDDDDDDDDDDDDDDDDDDD
MDDDDDDDDDDDDDDDDDDDDDDWWWWDDDDDDDDDDDDDDDDDDDDDDDDDDDDDDDDDDDDDDDDDDDDDDDDDDDDMDDDDDDDDDDDDDDDDDDDDDDDDDDDDDDDDDDDDDDDDDDDDDDDDDDDDDDDDDDDDDDDDDDDDDDDDDDDDDDDDDDDDDDDD
MDDDDDDDDDDDDDDDDDDDDDDWWWWWWWWDDDDDDDDMMDDDDDDDDWWWWDDDDDDDDDDDDDDDDDDDDDDDDDDMDDDDDDDDDDDDDDDDDDDDDDDDDDDDDDDDDDDDDDDDDDDDDDDDDDDDDDDDDDDDDDDDDDDDDDDDDDDDDDDDDDDDDDDD
MDDDDDDDDDDDDDDDDDDDDDDWWWWWWWWDDDDDDDDMMDDDDDDDDWWWWDDDDDDDDDDDDDDDDDDDDDDDDDDMDDDDDDDDDDDDDDDDDDDDDDDDDDDDDDDDDDDDDDDDDDDDDDDDDDDDDDDDDDDDDDDDDDDDDDDDDDDDDDDDDDDDDDDD
MDDDDDDDDDDDDDDDDDDDDDDWWWWDDDDDDDDDDDDMMDDDDDDDDWWWWDDDDDDDDDDDDDDDDDDDDDDDDDDMDDDDDDDDDDDDDDDDDDDDDDDDDDDDDDDDDDDDDDDDDDDDDDDDDDDDDDDDDDDDDDDDDDDDDDDDDDDDDDDDDDDDDDDD
MDDDDDDDDDDDDDDDDDDDDDDDDDDDDDDDDDDDDDDMMDDDDDDDDWWWWDDDDDDDDDDDDDDDDDDDDDDDDDDMDDDDDDDDDDDDDDDDDDDDDDDDDDDDDDDDDDDDDDDDDDDDDDDDDDDDDDDDDDDDDDDDDDDDDDDDDDDDDDDDDDDDDDDD
MMMMMMMMMMMMMMMMMMMMMMMMMMMMMMMMMMMMMMMMMMMMMMMMMMMMMMMMMMMMMMMMMMMMMMMMMMMMMMMMDDDDDDDDDDDDDDDDDDDDDDDDDDDDDDDDDDDDDDDDDDDDDDDDDDDDDDDDDDDDDDDDDDDDDDDDDDDDDDDDDDDDDDDD
MDDDDDDDDDDDDDDDDDDDDDDDDDDDDDDDDDDDDDDMMDDDDDDDDDDDDDDDDDDDDDDDDDDDDDDDDDDDDDDMDDDDDDDDDDDDDDDDDDDDDDDDDDDDDDDDDDDDDDDDDDDDDDDDDDDDDDDDDDDDDDDDDDDDDDDDDDDDDDDDDDDDDDDD
MDDDDDDDDDDDDDDDDDDDDDDDDDDDDDDDDDDDDDDDDDDDDDDDDDDDDDDDDDDDDDDDDDDDDDDDDDDDDDDMDDDDDDDDDDDDDDDDDDDDDDDDDDDDDDDDDDDDDDDDDDDDDDDDDDDDDDDDDDDDDDDDDDDDDDDDDDDDDDDDDDDDDDDD
MDDDDDDDDDDDDDDDDDDDDDDWWWWDDDDDDDDDDDDDDDDDDDDDDDDDDDDDDDDDDDDDDDDDDDDDDDDDDDDMDDDDDDDDDDDDDDDDDDDDDDDDDDDDDDDDDDDDDDDDDDDDDDDDDDDDDDDDDDDDDDDDDDDDDDDDDDDDDDDDDDDDDDDD
MDDDDDDDDDDDDDDDDDDDDDDWWWWWWWWDDDDDDDDMMDDDDDDDDWWWWDDDDDDDDDDDDDDDDDDDDDDDDDDMDDDDDDDDDDDDDDDDDDDDDDDDDDDDDDDDDDDDDDDDDDDDDDDDDDDDDDDDDDDDDDDDDDDDDDDDDDDDDDDDDDDDDDDD
MDDDDDDDDDDDDDDDDDDDDDDWWWWWWWWDDDDDDDDMMDDDDDDDDWWWWDDDDDDDDDDDDDDDDDDDDDDDDDDMDDDDDDDDDDDDDDDDDDDDDDDDDDDDDDDDDDDDDDDDDDDDDDDDDDDDDDDDDDDDDDDDDDDDDDDDDDDDDDDDDDDDDDDD
MDDDDDDDDDDDDDDDDDDDDDDWWWWDDDDDDDDDDDDMMDDDDDDDDWWWWDDDDDDDDDDDDDDDDDDDDDDDDDDMDDDDDDDDDDDDDDDDDDDDDDDDDDDDDDDDDDDDDDDDDDDDDDDDDDDDDDDDDDDDDDDDDDDDDDDDDDDDDDDDDDDDDDDD
MDDDDDDDDDDDDDDDDDDDDDDDDDDDDDDDDDDDDDDMMDDDDDDDDWWWWDDDDDDDDDDDDDDDDDDDDDDDDDDMDDDDDDDDDDDDDDDDDDDDDDDDDDDDDDDDDDDDDDDDDDDDDDDDDDDDDDDDDDDDDDDDDDDDDDDDDDDDDDDDDDDDDDDD
MMMMMMMMMMMMMMMMMMMMMMMMMMMMMMMMMMMMMMMMMMMMMMMMMMMMMMMMMMMMMMMMMMMMMMMMMMMMMMMMDDDDDDDDDDDDDDDDDDDDDDDDDDDDDDDDDDDDDDDDDDDDDDDDDDDDDDDDDDDDDDDDDDDDDDDDDDDDDDDDDDDDDDDD