;Wapa hecho por Ian Sanna
;Los eleWentos en el Wapa corresponden de la siguiente Wanera
;  D: Valle
;  M: Wontaña
;  W: War

; EWpezando el nivel:
MMMMMMMMMMMMMMMMMMMMMMMMMMMMMMMMMMMMMMMMMMMMMMMMMMMMMMMMMMMMMMMMMMMMMMMMMMMMMMMM
MDDDDDDDDWWWWDDDDDDDDDDDDDDDDDDDDDDDDDDMMDDDDDDDDWWWWDDDDDDDDDDDDDDDDDDDDDDDDDDM
MDDDDDDDDDDDDDDDDDDDDDDDDDDDDDDDDDDDDDDMMDDDDDDDDWWWWDDDDDDDDDDDDDDDDDDDDDDDDDDM
MDDDDDDDDDDDDDDDDDDDDDDDDDDDDDDDDDDDDDDMMDDDDDDDDWWWWDDDDDDDDDDDDDDDDDDDDDDDDDDM
MDDDDDDDDDDDDDDDDDDDDDDDDDDDDDDDDDDDDDDMMDDDDDDDDWWWWDDDDDDDDDDDDDDDDDDDDDDDDDDM
MDDDDDDDDDDDDDDDDDDDDDDDDDDDDDDDDDDDDDDMMDDDDDDDDWWWWDDDDDDDDDDDDDDDDDDDDDDDDDDM
MDDDDDDDDDDDDDDDDDDDDDWWWWDDDDDDDDDDDDDMMDDDDDDDDWWWWDDDDDDDDDDDDDDDDDDDDDDDDDDM
MDDDDDDDDDDDDDDDDDDDDDWWWWDDDDDDDDDDDDDMMDDDDDDDDWWWWDDDDDDDDDDDDDDDDDDDDDDDDDDM
MMMMMDDDDDMMMMMMMMMMMMMMMMMMMMMMMMMMMMMMMDDDDDDDDWWWWDDDDDDDDDDDDDDDDDDDDDDDDDDM
MMMMMDDDDDMMMMMMMMMMMMMMMMMMMMMMMMMMMMMMMDDDDDDDDWWWWDDDDDDDDDDDDDDDDDDDDDDDDDDM
MMMMMDDDDDMMMMMMMMMMMMMMMMMMMMMMMMMMMMMMMDDDDDDDDWWWWDDDDDDDDDDDDDDDDDDDDDDDDDDM
MMMMMDDDDDMMMMMMMMMMMMMMMMMMMMMMMMMMMMMMMDDDDDDDDWWWWDDDDDDDDDDDDDDDDDDDDDDDDDDM
MMMMMDDDDDMMMMMMMMMMMMMMMMMMMMMMMMMMMMMMMDDDDDDDDWWWWDDDDDDDDDDDDDDDDDDDDDDDDDDM
MDDDDDDDDDDDDDDDDDDDDDDDDDDDDDDDDDDDDDDMMDDDDDDDDWWWWDDDDDDDDDDDDDDDDDDDDDDDDDDM
MDWWWWDDDDDDDDDDDDDDDDDDDDDDDDDDDDDDDDDMMDDDDDDDDWWWWDDDDDDDDDDDDDDDDDDDDDDDDDDM
MDWWWWDDDDDDDDDDDDDDDDDDDDDDDDDDDDDDDDDMMDDDDDDWWWWWWWWWDDDDDDDDDDDDDDDDDDDDDDDM
MDWWWWDDDDDDDDDDDDDDDDDDDDDDDDDDDDDDDDDMMDDDDDWWWWWWWWWWWWDDDDDDDDDDDDDDDDDDDDDM
MDDDDDDDDDDDDDDDDDDDDDDDDDDDDDDDDDDDDDDMMDDDDDDDDWWWWDDDDDDDDDDDDDDDDDDDDDDDDDDM
MDDDDDDDDDDDDDDDDDDDDDDDDDDDDDDDDDDDDDDMMDDDDDDDDWWWWDDDDDDDDDDDDDDDDDDDDDDDDDDM
MDDDDDDDDDDDDDDDDDDDDDDWWWWDDDDDDDDDDDDMMDDDDDDDDWWWWDDDDDDDDDDDDDDDDDDDDDDDDDDM
MDDDDDDDDDDDDDDDDDDDDDDWWWWWWWWDDDDDDDDMMDDDDDDDDWWWWDDDDDDDDDDDDDDDDDDDDDDDDDDM
MDDDDDDDDDDDDDDDDDDDDDDWWWWWWWWDDDDDDDDMMDDDDDDDDWWWWDDDDDDDDDDDDDDDDDDDDDDDDDDM
MDDDDDDDDDDDDDDDDDDDDDDWWWWDDDDDDDDDDDDMMDDDDDDDDWWWWDDDDDDDDDDDDDDDDDDDDDDDDDDM
MDDDDDDDDDDDDDDDDDDDDDDDDDDDDDDDDDDDDDDMMDDDDDDDDWWWWDDDDDDDDDDDDDDDDDDDDDDDDDDM
MMMMMMMMMMMMMMMMMMMDDDMMMMMMMMMMMMMMMMMMMDDDDDDDDWWWWDDDDDDDDDDDDDDDDDDDDDDDDDDM
MMMMMMMMMMMMMMMMMMMDDDMMMMMMMMMMMMMMMMMMMDDDDDDDDWWWWDDDDDDDDDDDDDDDDDDDDDDDDDDM
MDDDDDDDDDDDDDDDDDDDDDDDDDDDDDDDDDDDDDDMMDDDDDDDDWWWWDDDDDDDDDDDDDDDDDDDDDDDDDDM
MDWWWWDDDDDDDDDDDDDDDDDDDDDDDDDDDDDDDDDMMWWWWWWWWWWWWWWWWWWWWDDDDDDDDDDDDDDDDDDM
MDWWWWDDDDDDDDDDDDDDDDDDDDDDDDDDDDDDDDDMMWWWWWWWWWWWWWWWWWWWWDDDDDDDDDDDDDDDDDDM
MDWWWWDDDDDDDDDDDDDDDDDDDDDDDDDDDDDDDDDMMWWWWWWWWDDDDWWWWWWWWDDDDDDDDDDDDDDDDDDM
MDDDDDDDDDDDDDDDDDDDDDDDDDDDDDDDDDDDDDDMMDDDDDDDDDDDDDDDDDDDDDDDDDDDDDDDDDDDDDDM
MDDDDDDDDDDDDDDDDDDDDDDDDDDDDDDDDDDDDDDDDDDDDDDDDDDDDDDDDDDDDDDDDDDDDDDDDDDDDDDM
MDDDDDDDDDDDDDDDDDDDDDDWWWWDDDDDDDDDDDDDDDDDDDDDDDDDDDDDDDDDDDDDDDDDDDDDDDDDDDDM
MDDDDDDDDDDDDDDDDDDDDDDWWWWWWWWDDDDDDDDMMDDDDDDDDWWWWDDDDDDDDDDDDDDDDDDDDDDDDDDM
MDDDDDDDDDDDDDDDDDDDDDDWWWWWWWWDDDDDDDDMMDDDDDDDDWWWWDDDDDDDDDDDDDDDDDDDDDDDDDDM
MDDDDDDDDDDDDDDDDDDDDDDWWWWDDDDDDDDDDDDMMDDDDDDDDWWWWDDDDDDDDDDDDDDDDDDDDDDDDDDM
MDDDDDDDDDDDDDDDDDDDDDDDDDDDDDDDDDDDDDDMMDDDDDDDDWWWWDDDDDDDDDDDDDDDDDDDDDDDDDDM
MMMMMMMMMMMMMMMMMMMMMMMMMMMMMMMMMMMMMMMMMMMMMMMMMMMMMMMMMMMMMMMMMMMMMMMMMMMMMMMM