;Mapa hecho por Ian Sanna
;Los elementos en el mapa corresponden de la siguiente manera
;  X: Valle
;  Y: Montaña
;  M: Mar

; Empezando el nivel:
YXXXXXXXXMMMMXXXXXXXXXXXXXXXXXXXXXXXXXXYYXXXXXXXXMMMMXXXXXXXXXXXXXXXXXXXXXXXXXXY
YXXXXXXXXXXXXXXXXXXXXXXXXXXXXXXXXXXXXXXYYXXXXXXXXMMMMXXXXXXXXXXXXXXXXXXXXXXXXXXY
YXXXXXXXXXXXXXXXXXXXXXXXXXXXXXXXXXXXXXXYYXXXXXXXXMMMMXXXXXXXXXXXXXXXXXXXXXXXXXXY
YXXXXXXXXXXXXXXXXXXXXXXXXXXXXXXXXXXXXXXYYXXXXXXXXMMMMXXXXXXXXXXXXXXXXXXXXXXXXXXY
YXXXXXXXXXXXXXXXXXXXXXXXXXXXXXXXXXXXXXXYYXXXXXXXXMMMMXXXXXXXXXXXXXXXXXXXXXXXXXXY
YXXXXXXXXXXXXXXXXXXXXXMMMMXXXXXXXXXXXXXYYXXXXXXXXMMMMXXXXXXXXXXXXXXXXXXXXXXXXXXY
YXXXXXXXXXXXXXXXXXXXXXMMMMXXXXXXXXXXXXXYYXXXXXXXXMMMMXXXXXXXXXXXXXXXXXXXXXXXXXXY
YYYYYYYYYYYYYYYYYYXXXXXXXXMMMMXXXXXXXXXXXXXXXXXXXXXXXXXXYXXXXXXXXXXXXXXXXXXXXXXX
YYYYYXXXXXYYYYYYYYYYYYYYYYYYYYYYYYYYYYYYYXXXXXXXXMMMMXXXXXXXXXXXXXXXXXXXXXXXXXXY
YYYYYXXXXXYYYYYYYYYYYYYYYYYYYYYYYYYYYYYYYXXXXXXXXMMMMXXXXXXXXXXXXXXXXXXXXXXXXXXY
YXXXXXXXXXXXXXXXXXXXXXXXXXXXXXXXXYYXXXXXXXXMMMMXXXXXXXXXXXXXXXXXXXXXXXXXXYXXXXXX
YXXXXXXXXXXXXXXXXXXXXXXXXXXXXXXXXXXXXXXXXXXXXXXYYYYYYYYYYYYYYYYYMMMMMMMMMMMMMMMM
YXMMMMXXXXXXXXXXXXXXXXXXXXXXXXXXXXXXXXXYYMMMMMMMMMMMMMMMMMMMMXXXXXXXXXXXXXXXXXXY
YXMMMMXXXXXXXXXXXXXXXXXXXXXXXXXXXXXXXXXYYMMMMMMMMMMMMMMMMMMMMXXXXXXXXXXXXXXXXXXY
YXMMMMXXXXXXXXXXXXXXXXXXXXXXXXXXXXXXXXXYYMMMMMMMMXXXXMMMMMMMMXXXXXXXXXXXXXXXXXXY
YXXXXXXXXXXXXXXXXXXXXXXXXXXXXXXXXXXXXXXYYXXXXXXXXXXXXXXXXXXXXXXXXXXXXXXXXXXXXXXY
YXXXXXXXXXXXXXXXXXXXXXXXXXXXXXXXXXXXXXXXXXXXXXXXXXXXXXXXXXXXXXXXXXXXXXXXXXXXXXXY
YXXXXXXXXXXXXXXXXXXXXXXMMMMXXXXMMMXXXXXXXXXXXXXXXXXXXXXXXXXXYXXXXXXXXXXXXXXXXXXX
YXXXXXXXXXXXXXXXXXXXXXXMMMMMMMMXXXXXXXXYYXXXXXXXXMMMMXXXXXXXXXXXXXXXXXXXXXXXXXXY
YXXXXXXXXXXXXXXXXXXXXXXMMMMXXXXXXXXXXXXYYXXXXXXXXMMMMXXXXXXXXXXXXXXXXXXXXXXXXXXY
YXXXXXXXXXXXXXXXXXXXXXXXXXXXXXXXXXXXXXXYYXXXXXXXXMMMMXXXXXXXXXXXXXXXXXXXXXXXXXXY
XXXXXXXXXXXXXXXXXXYYXXXXXXXXMMMMXXXXXXXXXXXXXXXXXXXXXXXXXXYYXXXXXXXXXXXXXXXXXXXX
YXXXXXXXXXXXXXXXXXXXXXMMMMXXXXXXXXXXXXXYYXXXXXXXXMMMMXXXXXXXXXXXXXXXXXXXXXXXXXXY
YYYYYYYYYYYYYYYYYYXXXXXXXXMMMMXXXXXXXXXXXXXXXXXXXXXXXXXXYXXXXXXXXXXXXXXXXXXXXXXX
YYYYYXXXXXYYYYYYYYYYYYYYYYYYYYYYYYYYYYYYYXXXXXXXXMMMMXXXXXXXXXXXXXXXXXXXXXXXXXXY
YYYYYXXXXXYYYYYYYYYYYYYYYYYYYYYYYYYYYYYYYXXXXXXXXMMMMXXXXXXXXXXXXXXXXXXXXXXXXXXY
YXXXXXXXXXXXXXXXXXXXXXXXXXXXXXXXXYYXXXXXXXXMMMMXXXXXXXXXXXXXXXXXXXXXXXXXXYXXXXXX
YXXXXXXXXXXXXXXXXXXXXXXXXXXXXXXXXXXXXXXXXXXXXXXYYYYYYYYYYYYYYYYYMMMMMMMMMMMMMMMM
YXMMMMXXXXXXXXXXXXXXXXXXXXXXXXXXXXXXXXXYYMMMMMMMMMMMMMMMMMMMMXXXXXXXXXXXXXXXXXXY
YXMMMMXXXXXXXXXXXXXXXXXXXXXXXXXXXXXXXXXYYMMMXXXXXXXXXXXXXXXXXXXXXXXYXXXXXXXXXXXX
YXXXXXXXXXXXXXXXXXXXXXXMMMMMMMMXXXXXXXXYYXXXXXXXXMMMMXXXXXXXXXXXXXXXXXXXXXXXXXXY
YXXXXXXXXXXXXXXXXXXXXXXMMMMXXXXXXXXXXXXYYXXXXXXXXMMMMXXXXXXXXXXXXXXXXXXXXXXXXXXY
YXXXXXXXXXXXXXXXXXXXXXXXXXXXXXXXXXXXXXXYYXXXXXXXXMMMMXXXXXXXXXXXXXXXXXXXXXXXXXXY
XXXXXXXXXXXXXXXXXXYYXXXXXXXXMMMMXXXXXXXXXXXXXXXXXXXXXXXXXXYXXXXXXXXXXXXXXXXXXXXY
YXXXXXXXXXXXXXXXXXXXXXMMMMXXXXXXXXXXXXXYYXXXXXXXXMMMMXXXXXXXXXXXXXXXXXXXXXXXXXXY
YYYYYYYYYYYYYYYYYYYYYYYYYYYYYYYYYYYYYYYYYYYYYYYYYYYYYYYYYYYYYYYYYYYYYYYYYYYYYYYY 
