;Map made by Santella Agustin
;element index
;  D : Diert
;  M : Mountain
;  W : Water

; starting the level:
DDDDDDDDDDDDDDDDDDDDDDDDDDDDDDDDDDDDDDDDDDDDDDDDDDDDDDDDDDDDDDDDDDDDDDDDDDDDDDDDDDDDDDDDDDDDDDDDDDDD
DWWWFDDDDDFDDDDDDDDDFWWFWWDDDDDDDDDFDDDDDDDDFIDDDDDDFDWDDDDDFWWDDDDDDWDWWDDDDDDFDFDDDDDDDDDDDWWDDDFD
DFWWWDWDDDDDDDDDDDDDWWDIFDDDDDDDDDDDDDDFDDDDDDWDFFDDWWWDDDDMDDDDDDDDDDDDDDDDWWDDDDDDDDDDDDDDDDDDDDDD
DDDDDDDDDDDDDDWWWDDDDFDDDDDDFDMDDDDDIDDDDDDDDWWDDDDDDDDFFDDDDDWWDDDDDDDDDDFFDDDDWDDDWWDDDDDFDDDWDFDD
DDDDDDDDDDMDDDDDDDDDDDDDDDDWWDDDDDDDDDDDDDDDFDDDDDDDDDDWWDDDDDDDDDDDDDDDDDWWFFDWDDDDDDDFDDWWDDDDDWDD
DDDDDDDDDDDDDFDDDFDDDIDDDDDDDDGDDDFMDWDDDFDDWWFDDDWDWDDDWWDDDFDDDFIFDDMDDWDDDWFWWDDDDDDDDDDDDDFDDDDD
DFWWWFDDDDDDWDDDDWWFDFDDWDDDDWFDDFDDFGDDFDDDDDDDDWWWWWFDDDDDDDDDDDFDDDDDWWDFDWWDDWWDWWFWWDDDDDDDWDFD
DDDDDDDDFDDDDDDIFDDDDDDDWWFDDWDWFDDDFDDDWFDDDDDDDDFDDDDIDDDDDFDDDDDDDDDDIDDDDDDDIDGDDFDDDDDDDDFWDFDD
DDDDDDWDWDDDGFDFDDDDDDDDDDWFDDDWWDDDWWDWDDDDDDDWWFDDDDGDDDDDDDFDDDWWWFFDDWWDDDWFDDDFDDDDFDDDDDFDDDDD
DFDDWDWDWWFDDDFWDWFDDDDDDDWWDDDDDDDDDDDDWDDDDDDDDDDWFIDDDFWWDDDDDDDDGDDDDDWWDFWDWDWWDMDDDDDDDFDDFDDD
DDDDDDDDDDDDIDDDFWDDDDWDDDDDDWDDDDDDDDDWWDDDDDDDDDWWDGDDDDDFFDDDDDDDDGDDDDDDDDDDWDDDDDDDDDDDFDFDDDDD
DDDDDDDWDDDWDDDDFDDDDFDDDDDDWWDMDWWWDDDDMDFDDDDDDDFDDFDDFWDWWFDDDDDDDDDDDDDDDDDDDDDDDDDDDDDWWFDDDDDD
DDDWWDWWDDFDDDDDDDDDDDDDDDDWDDMIDDDDDDDFFWWFDDDDDDWWWDDDDDDDDDDDDDDDDDDDDFDDDDDFDDDDDDDDDDDMDDDDWWFD
DDDFWFDDDDDDFDDDWWWDDDDDIDDDFDDDDDDDDDWWFDFDDDGDDWWDGDWWDDDFDDDDDDDDFDDDDDDDDDFWWDDFDDDDDDDDDDDDDDWD
DDFFWFDDGDDDMDWDIFDDDDDFFWWFWWDWWDDDDDDFWWWWDDDDDDDDDDDDDDDDDWWDDDDDWDDDDDDDDDIDDDDWWFDDWWDFWWDDDDDD
DDIFWFDDDDDDDWWDDDDDDDFIDDFFDDDDDDDDDDDWWDDDDDDDDDDDFWDDDDDDDDDWWWWFWWWDDDFWDDDWWFDDWDDDDDDDWDDDDIDD
DDDDDDDFDDDDDDMDDDDDDMDDDDWWDDDDDDDDGDWDFWDDDDDDDDDDDWWDDDDDDDDDDDDDDDDDDDWWDDDDDDFWWFDDWDDDDDDWWDMD
DWDDDDDDDMDFDDDDDDDDDDDDIDDWWFDDDDWWDDWWWFDWDDDDDDDWWDDDDDMDMDDMDDDDDDWDDDDDDDDDDDDDDDFWWWFDDFWFDDDD
DWWDDFWDDDFDDWDDWFDDDDDDMFDDDDDDDDDDDDDDWWFDDDDDDDDDWFDDDDDDDDDDFDDDDWWWDDDIDDDDWWFDIDFDDDDDDWDDDIDD
DDDDDDDDDDMDDWFDWWFDDDFDDDFWWDDDDDDDWWDDDDDDDDDDDDDDWWDDDDDDGFDDDDDDDIDDDDDDDDDDWDDDDWWFDDDDDFDDFDDD
DDDDDDDDDWFDDDMDDDDDDDDDDDDDDDDDDDDDDDFIFWWWDDDDDDWDWWDFDDDDDWDDDDDFDDDDDDDDDDDDDDWDWWDDDWDWDDDDWWDD
DFDDDDWWWWDWWDFDDDDDDFDWWDDDWWDDDDDDDDDDDDWWWDDDFWWDDDDDDDDDDDDDFDDDFDDDWDDDDDDWDFWWDDDDFDDDDDDWWDDD
DDFWDDDWWDDDDDDDFDDDDDDDDDGDDDDWDDWDDDDDDFDDDDDDDDDDFFDDDDDDDFDDDDDDDDDDDIFWFDDDDDDDDDDFDDWDDDDDDDDD
DDDDDDDDDMDDDWDDDDDDDDDDDDDDDDDWWWDDMDDDDWDWWDDGDDDDWWDDFDDDDWDDDWDDDDDDDDDWWDDDDDFDDDDDDDWDDDDWDDDD
DWWDDWWDGDDDDDDDFWDFDWFDDDDDDDDDDDDDDFDDDDDDFIFFWFWWDWFDDDFDFDDDDDDDDDDDDDDWWFDDMDWWDWDDDDWWDDWWWDDD
DDFDDWWDDDFDDFDDDWWWDDDDFDDDWWWDDDDIDDIDDFWDDDDFWWDDDDGDDDDDDDDDDDWWDDWWWDDDDDDDDFWDDWWFDDDDDGDDWWWD
DDDFDWDDDDDDDDDDDDDFDDDDDDDFDDDDDDDDDDDDDDDDDDWWWDGDDDDDWDDDDDDDDDDWWDDDWDDDDDDWFWDDDDDFDDDDDDDDDWFD
DDFDDDDDDDWWDIDDDDFWWWFDDDWWFDDIDDDGDDIDDDDDDDDDDDDDDDDDDDDDDDFDDDDDWFDDWDDDDDFDDDDDDDFDDDDDDDDDFWDD
DWWDDDDDDDDWFDDDWDDDDDDDDDDDDDDDDDDDDDDDDDDDDDDDDIFDDDDWDWDDDDDDDDWWWDDDDDDDDDDDFDDFDDWDDDFWWDDDFDDD
DDDFDFDDFWWWDDDDDFDDDFWDDDDDDDDDDDDDDDDDDDDDDDDDDDFDDDDDDWWDDDDDDDDDDWWDDDDFDDDDDDDDDDWWFDDDDDFGFFWD
DDDDDWWDDDDDDDDDDWFDDWWWWDDWDDDDWWDIDDDDGFDDDDFDDDWWDDWDDDFWWDDDDDDWDWWDDDDDDDFWDDDWFDWWWDDDDDDDDDWD
DDDDDDDDDDFDDDDDWWWWDFWWDDDWDWWFWDWFFDDFDDDDDFDDDDDDDWWDFFWDDDDDDDDDDDDWWDDDDDDWDDDWDDIDFFDDDDDDWDDD
DDDDDDDDDFDDIDDDDDWWDDGDFDFWWWWDDDWWWWFDDWWDDDDDDDDDDDDDWDDDDDDDDDDDDDDDDDDDDWWWDDDDDDDFWWDDFDDWWWWD
DDIFDDDDDDDDDDDDDDDDDDDDDDWDDDDWDIDDDDDDWWDDDDDDDDGDDDDDWWFDWWDDDDDDDFDDDDDFDDDDDDDDFDDDDDDDWWDDDDDD
DWFDDDDDDDDDDDDDDDDFDDDDDDIDDDDDDDDDDDDFWDDDDDDDDDDDDDDDDDFWDDDDDDDDFDDFDFDDDDDDDDDDDDDDDDDDDDDDDDDD
DDDDDDDDIDDDDDWWDDDDDWWWFWFDDDDDDDFDDDDDWDFDDFDDWDDDDDDWDGDDWFFDDFDDIDDFDWDDWWDDDFDDDFDDDDWDDDDDDDDD
DFDDDDDDDDIDWWWDDDIDWWDFWWWDDDDDDWWFDDDWWWWDDDDDDDDDDDWFDDDWWDDDDDDDIDDWWWDDDDDDFDDDWWDDDFWDDDWDWWFD
DDDDDMDDDDFDDDDDDDDDDDWDDDDFWDDDDWDIDWWDDDDDDDDDGDDDDFWWDGDDDDDDDWFDDDDDDDWFDDDWWWDDDWFDDWFDDDWWDDDD
DDDFDFDDDDDDDDFDDWDDDWFDDDDDWDDDFWWDDDGFDDFDDFDDDWWDDDDDDDDMDDDDFDDDDDDDFWWDDDDWDDDDWFDDDWWDDDDDGDDD
DDFDDDDDWWDDDDDDDDDDDDWDDDDDDDDDDDDDDDDDDDDGFGDDDDFDDDDDDDDDDDDDDDDFDDDDDDDDDDDWWWWDFDDDMDDDWDDFDDDD
DDDDFDFDWDDDDDDDIDDDFDWWDDDDDDDDDDWDDFGDDDDDDDDGDDDDDDDIDDDDFDDDDDDDDDMDDDWDDDDDFGDDFDWFDDDFDDDDDDDD
DGDDWWWDMDDIDGDDDIFWWDDDDFDDGDDDDFWDDDDDDDIDDDDDDDDDFDDDIFFWWDDDDDDDDDDDDDDDDDDDDDDDWWWWFWDDDMDDDDWD
DFDDDFDFGFDDDIDDDDFWWDDDDDDDDDDDDDWFDDDDDDDDWWFDIDDWWDDWDWDDDDDDDDFMFFWDDDFDDDFDDGDDDDDDDDDWDDDIDWWD
DDDDFDDWDFDDDDDFDDDDDDDMDDDDDDDDFDDDDDDDDDFDDDDDDDDDDDDDDWWFDDDDDDDFDDWWDDWDDDGDDDDIFGFDDDDDDDDFDDDD
DDDDDDDWWWFIDDFDDFDDFDDDDDDDDFDDWFDGDDDDDDDDDDDDDDFDDDDDDDDGDWWDDDDDFWDDDDWDDDDWWDMDIFDWWFDDDDDDDDWD
DWWDDDDDDDDFDDDDDDDFDDDDDDDDDDDFWFDDDDDFWWDDDDIFDDDDDDDDDDDDDDDDDDDDDWDMDWDDDDDDFDDWDDDDDDDWWDDWWWFD
DDWWDDDDDDDWDWDFWWFWDDWWWWFDDDDWWFWWDWWWFDDDDDDDDDWWDDDWWFDDDDFDDDDDDWWDDDDDDDDDWWDWWDDDDWFDWWWDDDDD
DDFWWDDDDDFDDWWDDDDDDDFDDWWDDIDIDDDDDDMDWDDDDDDDFDDDDDDDDDDDDDDDDDDDWFDDDDDFDMDDDDDWFIDDDDDDDDWWDDDD
DDDDDDGDDDWFDDDDDDDGDFDDDDDDDDDDDDDFFWDFDDDWWWDWWFDDDDMDDDDDDDDDFDFDDWDDDFWWDDDDDDWWDDDDDDWWDDDDDDDD
DDDDDDDDDDWWWWWDDDDDDDDDDDDDDDDDDDDWWWDDDDDDDFDFDDDDDDDWWDFDDDDFDDWFDDFWWWFDDDDDDDDDDDDDDDIDDDWWDDMD
DDDDGDDDDDDDDDFDDDDWDDDIDDDDDDDDDFDDDDDDFDDDFWDDFDDMDDDDDFWFDDDWDDWDDDDDDDDDDDFWDDDDDDMFDDFDMDDDDDDD
DDDDDDDDDDDWWDWWFDDWWDDDDDDDFDDDDDDGDDIDDDDFWWDDWDDDDDDDDWDDDDFDFDWFDGDDFDDWWWDDDDDDGFDDIDFDDWFDDDDD
DDDDDDDDDDDDIFDDDDDDDDDDWDDDWWDDDDDDDDDDDDDDMDDDDFDGDDDDDDDDDDDDWDWDDDDDDDIDDDFDDDFDDDDDFWWWDDDWWDWD
DDDDFDDDDDFIDDDDWFDFDDDFDDDDDDDDDFWWDDDDWDFDDDWWFDDDDDFDDDDDFDDDDDDIDDDDDDDDDDDDDDDDDDDDDDDDDDDWWDDD
DDDDDDDDDDDDDDDDWWDDDDDWFDWWDDDFDDDDDDWWDDDDDFDDFWDIFDWDDWDDDDDWDDDDDDDDDDDDDDDFDWWDWDDDDWDDDDWWDDDD
DDDDDDDDDDDDDDDDDDDFDDDWWWDDDDDDDDDDIDDWWWDFWWFDDWWDDDWWWFDMDIFDDFDDDWWFDDDDDDWWDDWDDDDDWWDWWWDDDIDD
DFDDDDDDDDDDDDDDDDDDDDDDDDGFDDDDFDDDDDDWDDDDDDDDDDGDDDDDWWDDDFDDWDDDDDDDDDDDDDDWWWWFDFDDDDDDFMDDDDWD
DDFDDDDDDDDWWFDDDDDDDDDDDDDFDDDFDDWWDDDDDDMDDDDDDDFDDFDFFDDDWDDDWWDDDDDWWDDDFDIDIFDDFDFDDWDDWDIDMDDD
DFDFDDDDDDDDDDDFWWFDIFDWWDWWWFDDDDWWFDDDDDDDDDDDDDWWFIDWWDDDDDDDWWFDDDDFWDDDMDDDDDDDDDDDDDDDWWDDDMDD
DDDWWFDDDWDDDDDDDWFDDDDDWWWDDDDDDDDDIDDDDDDWDDDDDDWWDDDDDDIDDDDDDDWWDDDDDIDDFDDDDFDDDDDDDDDDDDDFDDDD
DDDFDDWWDWWFWWDDDWDDDDWDDDDDDMDDDMDDDDDDDDDDDDDDDDDDDDDWDDDDDDDDDWFDDDDDDDIDDFDDDDDFDDDDMDFWWDDDDFDD
DWDWDDDDDDDIDDFDFWWDDWWFFWDDWDDDDDGDIDDDDDDDDDDDWWWDDDWWDDWWDDDFFGDDFDDDDMFDDDDDDDDWWDDDFDWDDDDDDFDD
DDDWDDDDDDDDDDDDDDDFWDDDDDDWDDWDDDDDDDDDDDDWWWDDDIDDDDDDDDDDDDFWWDDDDDDFDFIDWFWWDDDDDDMDDDDDDWFDDDDD
DFDWDDIDDDDDDDDDDDDDWWFDDDDWWDDDDDDDDDWDWFDDDDDDDDDDDDDWDDDDDDDFDDDDDDFDDFIDDDDDDDDIDDIDDFDDDWDWWDDD
DWWDFDMDDWDDDFDDDDFDDIDDDDDDDDDDDFDDDWWFWDFDDDDDIDDDDDWDFWDDDDMDDDDDDDFDDDDWDDDDDWDDDDDGDMDDWWFMDDDD
DDDWWDDDWWDDDDDWDDDDIFDDDDDDDDDDDWWDDDDDWWDDDDDDDDDDFDDWWWWDDDDWWDDDDWWFDDDWWDDDDWWDDDDDWDDDDDDDDDDD
DDDDDDDDDDDWDDDWWDDDDIFDDDGDWWWWDDDDDDDDDDDDDWDDDDDDWWWDDDDDDDDDDFDWWDDDDFDDDDDDIDDFGDDDWFDDDDDDDDDD
DDMDDDDDFWDWWDDDDWWDDDFWWWFDMDDDMDDDDDDDDWDDDDDDDFDDDDDDDDDDFDDDDWWDDDDDDDDDWDDDDDDWDDDDDDDDFIDDDDDD
DDDDDDDDDWDDDDDDDGDDGDDDFWFDDDDDDDDDDDDDDDDDDDWDFWDDDDDDDDDFDDWFDDWDFDFDDDDDWWDDDDDDDDDDDDDDMDDDDFDD
DDDDDDDDDDDDDDDWWDDDDDDDDDDDDDDDDDDDDDDDDDDDDWDDDDDWDDDDDDFDDFDFDDWWWFWDDDFDDFDDDDDDDDMDDDDDDDDFWWDD
DDFDDDFDDDDDDDDWDDFWDDWDDFDFMFDDDDDDFWDDDDDDIDDDDDDDDDDDDDDDWFDWDDDFDDWWWDDDDDDDDDDFDDDDWDDDDGDFDDDD
DDWDDDWFDIDDDDDFWFDWDFDDFIDDDDDDDDFIDWDDDDDDIDFDDDDDDDDMDDIDDDWWWFDDFWDDDDDMDDWDDGDDDDDDDDDDDDDWWDDD
DWFDDDDFDDDWDDFDWDDDDDDDDDDDDDDMFDDDFIDDDDDDDDWWDDDDDFDDDDFDDDDFWWWWDDFDDDDDDDWDDDDDDIDDDDDDDDDFDDFD
DDWDDDDWWDFDDDWDDDFDDDDDFWDDDDDDWWDDDDWDDDDDDDDWWWDDDDMDDDWWDDDDDDDDDDDDDWWWDDDDDDFDDDDDDDDDDDDDDDDD
DDDDDDDWWDDDDDDDDDWWDDDFDMDDDFDDDDDWDFWDDDDDWFDDDDFDDDDWWWDDDDFDDDDDDDDDDDDDDDDDDDWDFDDDDWWDDWFDDDFD
DDDDFDDDDDWWDDDDFDDFDFDWWDDFDWWDDDFWWDWDWFDDDDDDDWWWDDDDDDDDDFDDDDDDDDDIDDWWDDDDDFDDWWDDDDDDWWDDDDDD
DDDDDDDWDFDDWFDFDDDWDDDDWWWWFDWWWDDDFWWWDDDFFDWDDWDDWWDWWDFWWDDWWDDDGDWDDDDDDDDDDDDDWDDDGDDDIDDDDDDD
DDDDFDDWWWDWWDDDDDDIDDFDGDDDWFDDFDDWWDWDWWFWWDDDDDDDDDDDFDDFDDFDDDDDIDDDDDDDDDDWWFDDWWDDFDDDDDDDDDDD
DDDDDDFDDDDDDDDDDDIDWDDDDDDDWDDDDDDFDDDDDDDDIDDDDDWWDDDDDDDDDFDDDDDDDWDDDDDDDFWWDDDDWDDDDDDDDDDDDDDD
DDDDDDDDDDDDDDDDDDDDDDDDDDDDDDDDDDDDDDDDDDDDDDDDDDDDDDDDDDDDDDDDDDDDDDDDDDDDDDDDDDDDDDDDDDDDDDDDDDDD