;Map made by Santella Agustin
;element index
;  D : Diert
;  M : Mountain
;  W : Water

; starting the level:
DDDDDDDDDDDDDDDDDDDDDDDDDDDDDDDDDDDDDDDDDDDDDDDDDDDDDDDDDDDDDDDDDDDDDDDDDDDDDDDDDDDDDDDDDDDDDDDDDDDD
DDDDDFDDWWDDDDDDDDDWDDWWWDDDDDFDDDDDDWDDDDFDDWFDDDDDDDDDDDDDWWDDDDDDDDWWWDDDDDWWDDDDDDFDDDDDDDDDDIDD
DDDDWWDDDFDDDDFDDDDDMDDDDDDFDFDFWWDDDDDWDDWWWWDDDDDDDIDDDDDDDDFWWDFFDDDDDDDDDDDFWDDDDFWFDDWWDDGDDFDD
DWWWWDDDDWWDDWWDDDDDDDFDDDDDDDDFDDDDDDDIFWWDFDDDDDDDDDWWFDDDDWWDDDDDGFDDFWWWDDDDDDDWWFWWFWWDDDDDDWWD
DDDDDDDDDDDDDDDDFWDDFDWDDDDDDDDDFWWDDFDFMDDWWDDDDDDDDDDDDDDDDDDDWWDDFFDDWDDGDDDDDDDDDDDDDDDDDDDDWDDD
DDDDDDDDDDMDDDDDDDDFWWWDDGFDDDDFWWDWWDDDDDWWDDDDDDDDDDDWDDDDDDDDDDDWWWDDDDDMFWWFDDDDIDDIDDDDWDDDIDDD
DDDDWWDDDDFWWDDDDDDDWDDDDDWWFDDDDDDIDDDDDDDDDDDDDDDDDDDWDDDDDDDDDDFDDDFWDDDDDDDDFDDDDDDFDDDFWWDDFDDD
DWWDDDDDDFDDDDDDDDDDDDDDDDWWWDDDDDDMDDDDDDDDDDDDDMDDDDDDDDDDDDDDDDDDDDDWDDDDDDWDDDDDDDDWDIDDDDDDDDDD
DDDDDMDDDDDDDWFDDDDDDWDDDDDDDDDDDDDDDDDDFWDDDDDDDFDFDWWDDDDWDFFDDDDDWDDDDFDFDDIDDWDDDDDDDDDDDDIDDDDD
DDDDDDFDDDWDDWDDDDDDDWWFDDDFDDDDDWWDDFWDDWWDDDFDDWDDDDDWDDWFFDDDDDWDDDDDDDDWWFDDDDFDDDFDDDFDDDDDDDDD
DFDDDDDDDFDDDMDDDDDDDDDDDDFIFDGDIDWDDDWDDDDDDDDDDDDDDDDWWDDDDDDDDFWWDFWWWFDWWWDDFDWFDDWWDWWDFIFDDDDD
DWWDIFDDDDDDDDWDDDDFDDWDDDDDFIFDDDDDFDWWFDDDDDDMDDDDDDFDDDDDDDDDDDDDDWWDDDDDDWFDDDDDDDDDFDDWWDDDDDDD
DFDDDDWDDDDDDDDDDFDDDWWWWWDDDFWWDDGDDDDDDDWWDWDDDGDDDFDFDDDDFWWDDDDDDDDDDDDDWWDWDDDDDDDWWDDDDDDMDDDD
DDDFDDWWFDDDDDDDDDDFDDDDDGDDDDDWWWDDDIDDDDDDDDDDDDDDDDMDDDDDWWWFDMDDWWWDDDIDDDDWDDFDDMDDDDDDDDDGDDDD
DDDWDWFDWWWWWDFFMDDWDDIFDDDDDDDDDDDDDDWDWDFDDDDDFDDDDDDDDDDWWFDDDDDDDDFDDDDFDFDWDDDDDDDGDDDDDFDDDDWD
DDFWWWFDDDDDDFWWDDFIDDDDDDDFDDDDFDDDFFWDWDDDDDDDWDDDDWDDDDDDDDFDDDDWFFDDDDDDDDDIFDDDDDDDDWDDDDDDDFDD
DFDFWDIDDDGFDIDDDDDDDDDDDDDDDWFFDMDDWWWDDDDDDDDWFDDIDDDFFDDDDDDDDFDDDDDDDDDDIDDDDDDDDDDWWDIDDDDDDDFD
DDDDWWDDDDFDDDDDWDDDDDDGFDDDWWWDFDDDIFDDFDWDDDDDDDDDDDDWWDDDFDDDDDDDDDWWDDDDDDDDDDFDDDDIDDDDDDMDDDDD
DDDDDDDDDWWWWDFWWDWWDDDDWDDDDFFDWWDDDDDDDDDDDIFDDDDDDDWFDFDDWWDWWFDDDDIDDDDDDDWWDDDDDDDDDIFDDDFFDDDD
DDDDDDDDDDDDMDFDDDDDDDDFIFDDDWWDFDFDDDMDDDDDDDDDWWDWDWDDDDDDDDDDDDDDDDDWDDDFDDDDDDDDDDDDDDDDDDWWDDWD
DWWDDDDFDDDDDDDFDDDDIDDFDDDDDDDDWDDDDDDFDGDDDFDDFDDDDDWWDDDDDFDDDDFDDDFWDDFDDDDDFWWDDFDIDDDDDDDDDDDD
DWDDDWFDDDDDDDDDDFDDDDDDDDDDDDDDWWWFDDDDDDWWDIFFDDDDDDDDDDDDDDDDWDWWFFWWWWWDDDDWDFDDDWWFDDMFWDDDDDDD
DDDFWDDDDDFDDDDDDDDDDDDDDDFWWDDDDDDWDDDDDDDDDDDDDDDDGDDDDDDDDDDWWFDDDDDDFDDFDDDDDDDDMDDDDDDDDMDDDDFD
DDDWWWDDDDDDDDDFDDDDDDMDDDFWWDDDDDFDDIDDDDDDDDDDDDDDDDGDDDDDDDDDDDWWDWWDWWWWDDDDFDDIDDDDDDDFFDDDFDDD
DDDDDFDDDDDDDDDDDDIDDDDDWWDDDDDDDIDDDDDDWDMIDDDDDDDDIDDDFDDDWWWFDDDFWWDDDDDDFDDDMDDDDFDFWWDWWDDDDDDD
DDDDDDDDDDDDDWWWDDIDDDDDWWFDFFWWDDDDDDDDDDDDDDDIDDFWDDDDWDDGDDDDDDDWFDDDDDDDDFIDDDWFDWWWWWFDWWDDDWDD
DDDDWFDWWWDDWDWDFDDDIDDDDDDWWFDDFDFMDDFWDDDDIDDDDDWDDDDFDDDDFFDDDDDWFDDFDDDDDDDDDDDDDMFDDWWDDDDDWWFD
DDDWWFDDDDWDWDMFDDDDDFDDWWDDWWDDDDDDFDFDDFDDDDDDFDFDFDDDDDDDWWWDDDDWWWDDFDDDFWDDDFDDDDDDDDDDDDDDDDDD
DDGDDDWWDDWWWWDDDDDDDDFIDWWFDDDDDDDDDDDFWFDWWDDDDFDFDDIDDDDDDDDDWWDDIDDIFDWWWWDDDDDDDDDDDDDDDDDDDDFD
DDDDDDWFWDDDDDMDDDDWWDDDDDDDDDDWWDDDDMDDWWDFDDDWWWDDDFDDDDDDDDDDDGFDDMFDDDDDFDFDDDDWWDDDDDDFWWDDDDDD
DDDDDWDDDDDDDDDDIDDFDDDDDDDDDDDWDFWFWDDDDDDDDFWWDDDDDWDDDWDDDDDFDDDDDFWDDDDFDDWWWWDIFDDDDDDDDDDDDDDD
DDDDDDDDDDDDDDDDDDDDDDIDDDDDDDFWDFWWWFDDIDDDWFDDDDDDDDDDDWWDDIDDDDDDDWWFDDDDDDDDDDDFDDDDDFDDDDDDDDDD
DDDMDDDDDDDDDIDDDDDDDDDDDDDFIDDDDDDDDFWDFDDDWWFDDDDDDDIDDDDDDDDDDDWWDDDDWFDDDDDDFDDDDDDDDDDDWDDDDDWD
DDDFWWDWDDDWFDDDDDDDMDDFDDDDDDDDDDDDDDDDDDIDDDDDDDWDIDFDDDDDDDDDDDDWDFDDDDDDDFDWWWWDFGDDDDDFWWWFGDWD
DDDFDDDDDDDWWDDFDDDDDDWWDDDDDDDDDFWDDDDFDDDDDDDDDDWDDWWWDDDDDDDDDDDDFDDDDDDDDDDDDDWWDFDDDDDDDDDDFWDD
DDWFDDDDGDDDDDDDDDDDDDDDDDFDDDDDDDWWDDDDFDDDDDDDWDWDDDFWDDGDDDWDDDDDDDDDFFDDDDDDGDDDDWDDDWFDDDDDDWDD
DFDDDMDDDDDDWWDDWWWDDDDDFDDDDDDWWDDDDDFDDDDDWDFWWWWDDWWWWDFDDDWDDDDDDDDWWWDDDDDDDDGDDDDDDWWWDDDDDWDD
DWDDDDWWDDDDDFDDDDDDDDDDWWFWWDDDDDWWWDDDDDDDDDDDFDDDDDDWWDDDDWWDDDDDDDDDFDDDDDDDDDDDDDFDDDWWFDWWDDDD
DDDDDDDDDDDWDDDFWWDDDDDDDDFWDDDDDDDDDMDWDDDDDDWWWDDDWWFDDDDDDDIDWWDDDDDDDFWWDDDDWDDDFDDDDDDDDDDDDDDD
DDDDFWDDDDFDDDDWWDDDDWFDDDDDDDDDFDDDWDDDDDDDDFDDDDDDDDFDDFDDDDFDDDIDDDDDDDFWDDWFWWDDWWFDDWFDDDDDMDDD
DDDDFDDDDDDDDDDDFDDDDWDDDDDDDDDDDDDFDDDDDDDDDWWFDDDWDFWWDDDDDDDDDDDDFDDDDDDWDDDDDDDDDDWWDDDDDDDDDFDD
DDDDDDDDDDDDDDDDDDDFWDDDFDDDDDDDDDDDDDDDDDDWDFWWDFWWFDDDDIDFDDDDDFDDDDDDDDFDDIFDDDWWDDFFWFDDDDWDDWDD
DDFDDDDDDWWDWDDIFDDFWWDWWFIDMDDDDDDDDDDDWDDDDDDDIDDDDDDDWDWWWDDWDDMDDDWWFDDDDDFWDDDDWDDFDDDDDWWDFWWD
DDDDDDDDFGDDDDDDDDDDDGDDDDDDFDDDDDDMDWDWWDDDDDDDFDDDDFDWWWFDDFWWDDDDDDDWWFDDDDDWWDDWWWDWDDDWDDDFWWFD
DDDDDDDFWDDFDDIFWWDDDDFDDDDFDDDDDWFFWWDDDDDDFDDFDFDDDWWDDDDDDDFFDDDDDDDDDDMDDDDDFDDDDDDWWWWDDDDDDDDD
DDDDDWDDDDDDDDDWDDDDDDDDDDDDDDDDWWDIDDDDDDFWDDDDDMDWDDFDDDDDDDDDFDFDDFDDDDDDDDDDWWDDDDDDDFWWDDDDDDDD
DDDFWWWWDMDDDDDDDDDDDDDDDDDDDDDDFMDDFDDDDDDWWFDDDDWWDIDDDDDDIDDDDFDDDDDDDDDIDDDWWFDDDWWFIFDDDDDDFDDD
DDDDDDDDFDDDDDDDDDDDDDFWWDDDDDDDDDDDDDDFDDDDDDDDDDDDDDDIDDDDDWWWDFDDDDWWDDDDDDDDFDDIDDDDDDDDDDDWWWDD
DDDDDDDWWDGDDDDDDWDDDDDDFDDDFDDDDDGDDDFDDWWDDDDDDDDDDDDIDDDDDDDDDDDIDDDFDDDDDDDDWDDDDDDDDDIDDDWFDDDD
DDDDDDGDDDDWDDDDDDDDDDDDWDDDDDIDWFDDDDDDDDDDDDDDWWDDDDDDDDDDDDDDDFDFFFDDGDDWDFDDDDDDDDDDDDIDFWWDDDWD
DDWDDDDDDDDWDDDDDDDDDDDWWWDDDDDDDFMDDWWDDDDDMDDDDDDWWFDFDDDDDDDDDDDWWWDDDDDDDDFDDFFDDDDFDGDDDDDDFWDD
DDWDDIFDDDDWWWDDDDFFWWFDDDDWWDFDDDDDDDDDDDDDDDDDDDDDDDDDDFDDDDDDDDDDFDDDDWWDDDDFWWWDDDDWWDDDDDDDFWWD
DDDDDDDDDDIFDDDDDDDIDDDWFFDDDDDFDDDDDDDDDDDDWWWDDDDDDDGFDWWDFDDDDDDDDDWWFDDWDFDWDDDDDFDDDDDDDFWDDDDD
DDDDDDFDDDDDDDDDWWDDDWWWDDDGDFWWDDDDDDFDDDDDDDMDDDDDDDDWDDWDDDDDDDDDDDDFDDDDFWDGDDDDDDDDDDDDDDDDDDWD
DWWDDDDDDDDDFDDDDDDDDWWDDDDDDGDDFDDDDDDDDDDDDDDDDDDDDDDWWDDDDDDWWFDDDDWWWDDDWWDDDDWDWDDDDDWDDDDDDFDD
DDDDIDDDDWWDDDDDDDDDDDDDDDDDDDDDWDWWDDDDDDDDDWWWWFDDDDDWWWFDFDDWWDDDDWWDDDDFWDDDDWFDWFFWWDDDDDDDDDDD
DDDDDDDDDDWDMDDDDDDDWDDWFDDDDDDDDDDDDDDWFDDDDDDDDDDFDIDDFDDDDDDDDFDDDDDDWWDWWDDFDDWWWFDDDDDDDDDDDDDD
DDDFDDDDDWDDDFDDDDFDDDDDMDDFDDFDDDDDWWWDDDDDDDDDDDDDDDWDFDDFWWWDDWDDDDDDDDDWDDDDDDDDDDIFDDWDDDDDDDDD
DDDDDFDDDFDDDDFFDWWFDDDDDDDDDDWDDDDWWWDDDDDDWWFDDDDDDWWDWDDDDFWWDDDWDDDDDFDWWWDDDDDDDDDIDWDDDFDDWDDD
DDDDDDFWWDDDDDWWDDDDDDDDDDDDDWWDDWWFDWFDDDDWDDDDFDDDDDFFWWDDWWDDDDWWWDDDFIDWDFDWFDDDDDDDDDWDDDDDMDDD
DDDFDFDDDDFDWWDDDDDDDFDWDDDDDDDDFDDDWWDDDDDWDDDDWDDDDWWDWWFDDDDDDIFDDDDDDFDWDDFWWWDDDDDFWDDDDDDDDDDD
DDDGDDDFWDIDDDDDDDDWWWDDDDDDDWWDWDWWDDDDDDDWDWDWWDDDDIDDDGDDDDDDDDDDDDDFWWFWWDDDDWFFDDDDWWDDWDDDDDDD
DIFFDFDDDDDDDDDDDGDWWDDDDDDDDDDFWFDDDDDDDDDWWWDDDDDDDDDDDDDDDWFDDFDDWWDDDDWWDDDDFDDDDDDDDDDDDDDDDDDD
DDWWDDFDFDDDDDDDDDDDFFDDDDDDFDDWWWDDDWWFDDDDDDDDWDDDWDDDWWWWDDDDDWFWWFDDDDWDDDDDDDDDDDFWWDDDDDDDDDDD
DDDWWFWFDDDDDDDDDWFFWWFDDDDDWDDDDWWDDDDDWWWDDDFWWDDDDDDDDDDDDDDDDIDWDDDDDWWDDDDDDDDDDDDWWFDIFFFDDDDD
DFWFDWWWDDFDDDDDWWDDDDWDDDGFDDDDDDDGDDDWWWDDMFDDDFDDFDDIFFDGDDDDDDDFWWDDFDDDMDDDDWDDDDDDDDGFDDFDDFDD
DDDWDDDFDDDDDDDGFDDDDWDDDWDDDDDDDDDDDDDWWDDDDDDDDDDDWFDDWWDDDDDDDDDDDWFDDFDDDDDDDIDDDWWDDDDDDDDDWWDD
DDFWWDDWWDDDDFDDDDDDWDWDDDDDDDDDDDDDFDDWDWDDDDDDDDDDDDWWWDWDDDDDDDDDDWWDWWDDDDDDDDFDFDDDDDDDWWDDDDDD
DDDDDDDDDDDDDDDWWWWDDDWDDDDFDDDDDDDWWDFDDDFDDFWWFDDDDDWWWWWFDDDFWWDDDDDDDDFWWFDIDWWWDDDDDDDDDDDDDDDD
DDDDDWWDFDDDIFDDDDDDDDWWWDWWFDDDDDDDDDDDDDFDFDDDMDDDWWDIDDDDFDDFDDDDDDIDDDDDDGFDDIDDDDIDFDGDDDDDDDDD
DFDDDDDWWDDDDFDDDDDDDDIDDDDDDDMDDDWWDDDDDDDFGDDDDDDDDDDDWWDDDFWWDDDDDDDWWDDDDDDDDDFFDDDDDDDDDFDDDDDD
DWWDDFWWFDDDDMDDDDDDWDDDDDWDIFDDFDDDDDDDDDFDDDDDDDDDDDDDDDDDDDWDDDDWWDFWFDWWDDGDDWWWFDDWDDDDDDDDDDDD
DWDDDDWFDDDDDDFDDDDDWWDDDDWWDWWDDDMDDDDDDDDDDDDDDDWWDDFDDDDDFWDDDDDDDDDDDDDDDDDFWWDDDDDWWDFDWDDDDDDD
DWFDWDDDDDDDDDDDDDDDDDFFDDIDDDDDDDDDDDIDDFDDDDDDDIDWWDDDDDDDFWWDDDDFWWDGFDDIFDDDFDDDDDDDDDDDDDDWDDDD
DWDWDDDDDDFDDDIFDWDDDDWWDDDDDDDDWDDDDDDDDWWFDDDDWFFDDDDDDDDDDDDDDDDFDDDDDDWDDFDDFDWWFDDDDDDDGDWWWDDD
DDDWWWFDIDDDDDDDDDDFDDDDDDDMDWWDDDDWFDDDDDDDDWFDDDDDDDFDDDDDDDDDDDDFDDDDDFDDDDDWWDFDDDDDDDDDIDDDDDDD
DDFWWDDDDDWWDDDDDDDDDWWWDWFDDDDDDWDDDDWWWFDDWWDDDDDDDDDMDDDDWWDDFDDWWDDFDDDDDDDDDDWDDDDDDDDWDDDDDDDD
DFWWDDDDDDDDDDIDDDDDWWDDDDDDDFDDDDDDDDWDDFDFFDDDMDDDDDDDDFDDDDDFDDDDDDFWDDIFGDDDDDDFDIDDDDWWFDDDDDDD
DWDDDDDFDDDDDDDDDDDDDDDDDDDDDDDDDDDDDDDDDWDWWDFGDDIFWDFWWWWDDIDDFWWDDDDDIDDDDDDDDWFDDDDDDDDDDWDFWDDD
DDDDDDDDDDDDDDDDDDDDDDDDDDDDDDDDDDDDDDDDDDDDDDDDDDDDDDDDDDDDDDDDDDDDDDDDDDDDDDDDDDDDDDDDDDDDDDDDDDDD