;Map made by Santella Agustin
;element index
;  D : Diert
;  M : Mountain
;  W : Water

; starting the level:
DDDDDDDDDDDDDDDDDDDDDDDDDDDDDDDDDDDDDDDDDDDDDDDDDDDDDDDDDDDDDDDDDDDDDDDDDDDDDDDDDDDDDDDDDDDDDDDDDDDD
DDFDDDDDDDFWWDWDDDDDDDDFDDDDDDDFDDDDDDDDDDDDDDDDDDDDDDMDWWDDDDDDWWDDDWWDDWDDWDDDWDFDFDWWFDDDDDDDDDDD
DDWDDDDDDDDDDFDDDDDDDDDWDFDDDDDWWWFDDDDDDDIDDDDDDDDMGFDWWDDDWDDDDDDDDDDDWWWDDDDDDFDDDIDDFDDDDWWDDDDD
DDDDDDDDDDDDDDDDDDDWWWWFWWDDDDDDDDDDDDDFDDDDDDFDDMDDGDDDDDDDDDDDDWWDDDFDWDDDDDDDDWFDDDDWWDDDDMDMFDWD
DDDDDDDDDDDDDFWFDDDFWWDWDDDDDDDDDDFDDDDWWDDDFWWDDDDDDDDDDDDDDWWFDDFWFFDDDDDDDDDDDWWFDDDDDFDDDDGDWDWD
DDDDFDDDDDDDDWWDDWDFDDWDDDFDDDDDDWWDDDGFDDDDDDDDDDDDDDDDDMDDWWDDDFWDDDDIDDDDDDDDWWDDFFWWDWWDDMDDWFFD
DMFWWDDDDMDDDIFDDWFDDDDDDWWDDDDDDDDDDDDDDFDDDDWWDDFDDDDDDDWWDDDDDMDWWDDDWFDDDDDFDDDDDDDIDDDWDDDDWWWD
DDDDDDDDDDDDWDDFWWDDFIFDWWWDDDWWDDDDDDDDFDDDMDDDDFWDDIFDDDDDDDWDDDDDDDDDDFWWFFDDDDDDDDDDDDDDDWDDDDDD
DDDDDDDDDDDDWWDDDDDDDDDWWWDWDDDDDWWDDDDDDDFDFWWDDDDDDDDDDDDDDDDDDDDWWFFDDDDDFDDDDDDDDDDDDDDDDWDDDDMD
DDFWDDDDWDDDDDDDDGDDDDDDDDWWDIDDDDDDDDFDDWWDFWFWWDDDDDDDDDDDDDDWWDIDWWWWFDDDWDDDDDDWWFDDDDDDDWWFWDDD
DWWWDDDWWDDDDDFDDDDFDDDDDDDFWDDDDDDDDDDDDDDDFWDWDDMDDDDDDDDDDDFDDDDWWWDDDFWDDDFDDDFDDDDDDDDGFDDWWWDD
DWDDDDDDFWFDDDDDDDDDDDDWWWFDWWDDDDDDDDFDDFDDDDDDDDDWDDDDDDIDDFWWDDWWFDDDDDDDDDDDDDWDDDWWDWDDDDDDIFWD
DDWWDDWWFWWDDDDDDDDDFDDDDDDDDDDDDDDDDWWWDWDDDDDDDDDWWWFDDDDDDDDDDDFDDDFWFDDDDDDDDWWWWWDDWWDDDDDDDWDD
DDDDDDDGDDDWFDDDDDMDDFDDDDWDDDDDIDDDDDGFWWDDWDDDDDDDIDWWDDDDDDGDDDDDDDDDDDDDIDDDDWDDDDDDDDDDDDDDDDWD
DDDDDDDDDDFWWDDGDDDDDDDDWWWDDDDDDDDDDDDDDDDDDDFDDDDDDDDDDDDDFDFDDDDDDDDGDDDFDDDDWWDDDFFDDWFDDDDWWWWD
DDDFDDFDIDDWDDDDWDDDDFDDDDDDDDFDDDDDDDDFDDWWDDDDWDDDWWDDDDDDDDDDDFWWFDDFDDDWWDDWDDDDWWFDDDDDDDDFDIFD
DDDDDDDDDDDWWDDDWWDDDDDFDDDDDWWDDDDDDDWWDDFDDDDDDDDDDDWWDDDDDDDDDDDDDDDDDWDDDFWFDDDDDDDDDFDDDDDDDDDD
DDDDDFDDDDDDDDDDDDDDDDWWDIDDWWFIDDDFDDDDDFDDDDDDDDFDDDWDDFDDDDDDDDDDDDDDFWWDDDDDDDDDDDDDFFDDDDDWDGFD
DDDDDWDDDDDDDFDDWDDFWWDDDDDDWFDDDDWWWWDDDDDDWDDDDDDFWFWDDDDDDDDFMDDFDDDDDDGFDDDDDDDDDDGDWWDDDDDIDDDD
DDDWWWWWWDWWDDDDDDWWFDDDDDDWFDDDDDDDDDDDWFDDWDDWDDDFWFWWDDGDDDDDDDDDDDDDDDDFDIDDDDDDDDDDFDDDDDDDDDDD
DDDFDDDDDDDDDDDWDDDDDDDDDDDDMFWWDWWDDDDDMDDFDDDDDFWWDWDDDDDDDDDDWWDWFFDDDWFWDDDDDDDFDDDDWWWDDDIDDDDD
DDWWWDIDDDDDDDDWFDDDDDDWWDDDDDDDDDDDDDDDDDDDDFDDDDDDWWDDDWFFDDDDGDDWDDFDDWDDFDDDDDDDDDDDDDDDFDDDWWDD
DDDDDDDDDDDDDDDWWDDDMDDDDDDDFDDDFDDDDDDDDDDDFWWDDDDDDDDDWWDWDDDDDDDDDWWFFDDDIDDDDDDDDDDFDDDFDDDDDDDD
DDDDDDIFDDDDDDDDDWFFDDWDDDDDDDDDDDDWDDDDDMDDFWFFDDDDDDDDWDDDDDDDDDDDDWFDFDDDDDDDDDDDWWDIDDDDDDDDDDID
DDFFWWDDDDDDDWDDDWWWDDWWDDDDDDDDDDWWDDWDDDDDDDGFIDDDDDDFDDDDDDDDDDDDDDWWWDDDDDDDDDDDWDFDDDDDDDDDDDDD
DDWDDDWWDDDDDWDWWDWDDDDDDDDDGDDWWDDDDWWDDDDWWWDFDDWDDDMDDDDFWWFDDDIDFWDIDDDDDDDDDDDDWWWDDDDDDDDIDDWD
DDWWDDDDDDDDWWDFDDDDIDWWWDDDDDDDDDDDDDDDFDDDDWWWDDDDDDDDDDDDDWDDDDDDDDDDDDWWDDDDDDDDDWWDDDDDDDDDDFWD
DMDDDDDDDDWWDDDDDIDDDDDDDDWDDIDDDDDMDWFDDDDDDDFDDDDDDDDWDDWDFDDDFWWDDFWWWFDDDDDDDDDDDDDDDDDDDDDDDWWD
DDDDDDDDDDDDWDDWWDDFDDDDDWWDDDMDWFDDFDFDDFDDDDDDDDDDDDDDDDWDDDDDGDDGDIDDDDWWDWWDDDDDDDDDDDDDDDDDDDDD
DDDDDDWWWDDDDDDDDDDDDDFWWWDDDDDDDIDDIDDDDDDDDDDDDDGDDDMDDFDDFWWDDDDDDDDWWDDDDWDDFDDDFDDDDDWDDDDWDWWD
DWDDWFDDDDDDDDDDDDDDDDDDDDDDDDDWDDDDDIDWDDDWWWDIDDDDDDDDFDDDFDDDDDDDDDDDDWDWDDDDWDDDDDDDDWWWFDFWWDWD
DWWDWWDDDDWDDDWDDDDDDDDDDDDDDDDDDFDGDFDDDDDDDDWDDDDDDDDDFDDDWWFMDWDDDDDDDDDWWDDDWFDDDDDDDDDDDDDDDDDD
DDMDDDDDWWWDDDDFWDDDDFDDDFDDDDDDFDDDDDDDDDDDDWDDDDDDDDWWWFDWDDDFWWWDIDDDDDDDDDDDDDDDDDDDDDFDDDDFDDDD
DDDDDDDDDDDDDDDWWWFWDGDIDDDFDDDFDDDFDDDDDDFDDFDDDIDDDDDDDDDDFDDDDDDDDDMDWWWDDDFDDWWFDDDDDDDFDDFDDWDD
DDFDDDDWWDWDIFDDDDWDDDDDFIDDFDDDDDDWWDDDDDDDDDDWDDDDDDDDDDDFDDDFDDDDDDFDDWDDDDDDWDDDDDDDDDDDDDDDFDFD
DDDDDDFDDDWDDMDDDDFDDDDDDDDDDDDDIDDIDDDDDDDDDDWDDDDDDDDDDDDIDDDWWDDDDFDDDDFFDDDDWDDWWFDDWDDDMFDIFDWD
DDDDWDDDDDDDDDDDDDDDDDFDDDDDDDDDDDWFMDDDDMDDDDDIDDDDDFDDDDDDDDDDDDFFDDDDDDWWDDDWWDDDFDDDDDDDFDDDDDID
DDDDWWFDDWDDDDDDDWDDWFDDDDDDWDDDFWWFFDDFDDDDDDDDDWFDDDDDMDDDDDFIDDWDDDDWWWFDDDFDDDDDDDDDDDDWFDDDDDDD
DDDDDDDDWWDDDDDDWDDDDDDDDDDDDDDDDDDFDDDDDDDDDDDWDDDDDFDDDDFWFDDDDDWWDDGFDDDDDDMDDDDWDDDWDDFDDDDDDDDD
DDDDDDDDDDDIFDGFWWDDDDDDDDDDDDDDDIDDDDDDDDDDDDWWWDDDFDDDDMDDDDDDDIFDDDDFDDDFWDFDDDDWDDDWDDDDWFDFWDDD
DDDDDDDDDWDDDDFDDDWDDWDDDDDFDDDDDIDDMDDDDDDDDDDDDDDDWFDDDDDDDDWWFDDDDDDDDDDWWDDDDDDWWDWWDDDDWWDWDDFD
DFDDDDDFWWFDWDFDIFDDDDDDFWWWDDDDDDWWDDDDDDDDWDFDFDDDDDDWWDDWDFGDDDDDDMFDDDDDDDDDDDWDDMDFFDDDDDMDDDWD
DDDDFDDDFDWDDDDDDDDDDDDDWDDDIDDDDDDDDDDDDDWDWFDDDDDDDDFWWDDDDDDDDDDDMFWDDDDDDDDDDDWWDDFWWDDDDDFDDFDD
DDWWWFDDWWFDDDDDDGDDFDDDWWDDDDDDDDDWWWDDDDWDWWDDDDDWDDDDDFWDFDFDDMDFDDWDDDDDDIDDFDDDWWDDWDDDDDDDDDDD
DDDDDDFDDWWDDDDIFDDDDDDDDDWWWDDFWDDDGDDDMDDDFDDDDDFDDDFIDWWDDDDDDDDIFDWWDWWDDDFDWFFDDDDDWWDFDDMDWDDD
DDWDDWWDDDDDDDWDDDWWWFDDDDWWWDDDDDDFDFWWDDGDDDDFDDDFDDDDWDDWDFDDDDDDWWDDMDDDDWWWWDWWDDDWWWDWWDDWWDDD
DDDDDFDDDDDDDWWWDDDDDDDDDDDDFDDDDDFWWWWDDDDDDDDDDDDDFWDFWWDDDDFDDDDDDDFDDDDDDFDFDDDDFWDDDDDDDDWDDDFD
DDDDFWWDDDDDDDDDDFFDDDWWDDDDDDDWDDDDDFDDDWWDFDDDWDDDDDFWFDDDDDDDWWDDDDDDDIDDDDFWDDDDWWDDFDDDDDDDDFWD
DDDDGDFWDMDDDDDDDDDDDDDWWFDDDDFDDDDDDDDDDDDDDDDWWDDDFDDDDDDDDDIDFFIDDDDDDDGDDDWWWDDIDDWWWDDDDDDMDDID
DWWDDDWDDDDDDDDDDDDDWDDDDWFWFDDDDDDDDDDDFWWDDDDDDDDWWDDDDDDDDDDFWWFDDDWWFDDDMDDIDDDDDDDDFDDDDFDDWWFD
DDDDDDWWWWWDIDDDDFDDDDDDDDDDDDDGDDDDDDDDDWWDDDDDDDWWDDDDDDDDFWDDDDDDFDDDDDDDDDDDDDDDIDDDWWDDDDDDDDDD
DDFDDDDDDDDDDWWFDWFDDDDMDDDDWDDDDDDDDDFIDDDDDDDMDDWWDDDDDDDDDWWDDIDDDDDDDWWDIDWDDDDMDDDDDDDDDDDDDDDD
DDDDDDDDDDIDDDDDDWDDDDDDDDDDWWDDDDDDDDDDWWDDDFIFDDDDDDDDDDWWDDDDDDDWDDWDDDWDDDWDDDDDDMMDDGDDDDDDDWFD
DDDWWDDWDFDDDDDDWWWWDDWDDDDDDDDDDDDDIFDDDDWWWDDIDDDDDFDDWDWDDWDDDDDDDWWDDDWFDDDDDFDDDDMDDDDDDMDWFDDD
DDDDDFWWWWDDWDFDDFFDDDDDDDDDWDDDDDWWDDDDDDDDDFIFDWWDWWWDWDWDDDIDDDDDMDDDDFIDDDDDDDDDDDDDDDDDDFWWFDDD
DDDDDDDDDDDDDFDDDWWDDDDDDDWDDDDDMDDFDDDDDDDDDDDDDDDDDIDDDDDDDDDDDDDDDDDDDDDDDDWFDFWDFDDDDDDDDDDDDGDD
DDDWDDDDDDDDFDDDDDDDDDFDDDDDDDDDDDDDFDDDDDFDDDDDFDDDDDDIDDDDDDDDWWDDDDDDWDWDDWWWDFDDDDDDDDDDDDDDDDDD
DDDWDDDDDDDWWWDGDIDDDDWDWDDDDWWFDDFDDDDDDDDDDDDDDFWWDDDDFDDDWFFWWDDDFDDDWWWWWWDDDWDDDDDDDDDDDDDDDDDD
DDFDDDDWWFFWWDDDDFWWWDDFDDDDDDWWDFWFDDDFDDDDIDFDDWWDDDDDDDWWWDDDDDDDWWWWWWDDDDFDDWWDDDDFDDDDDFDDWFWD
DDDDDDFDDDDIDWDDDDDDDDDDDDDDWDWWDDDDDFDWDFDDDDDDDFDWWDDDDDDDIDDDDDMDDFFWFDDDDDDDDDDDDDDWDDDDDWWWWDWD
DDFDDDWDDDDDDWDDDGDDIDDDDDDDDDDDDDDDFWWWWWWDDDDDFDDDDDDDDMDDGDFWDIDWWWDWWDDDFDDWWDDDDDWWWWDDIDFDDDDD
DDDDWWDDWDWWFWDDDDDDDWWFDDDDDDDDDDDDDDFDMDDDDGDDDDDDDWWDDIDDDDDIDFDFDDDDDDDDDDDDDDDDDIDFDDWWDWWDDDDD
DDDDDFIDWWDDDDDDDDDDDDDDDDDDDDFDDDFDDWWFDDDMFDDDDDDDDDFDDDDDWDDDDMDDDDWDDFFDDDDDDFDDDDWWDDDDDDDDDFDD
DDDDDDDWWDFDDDDDDDDWWFDMDDDDFDDDDDDDWWFDDDDDDDMDDFDDDDDDDFDFWWWWDDDDDDIFDWWWDDFDFWFDDDDWDDWWDDDDDDDD
DDDFDDDDFDDFWDDDDDDDWFDIFWDDDDDDDDDDWDDDDDDDDDDWDDDDFDDDDDDDDDWDDDFDDDDDDDDDDDDDWWWDIDDWWDDDDDDDDDDD
DDFWDDDDWFFDDDDDFDDDDDDDDWWDDDDDDDDDWWDDDDDDDDDWDDDFWWWDDDDDDDDDFWDDDDDDWDWDDDDDDDDDDDDDDDDDDWWFDDDD
DDWWFDDWWDDDDDDDDDDDDDDDDDDDDDGDDDDDDDDMDWDDDDDWWDDDDDDDDDDDWDDDFWDDDIDWWWWDDDDFWWDDDDDFDDDFDMDFWWWD
DDDDDDDDDDDDDDDDDDIFDDWDDDDFFDDDDDDDWDDFWDDDFDDDDDDWWWDDDWDDDDWFWWFDDDDDWDDDFDFDDDDFDDDWWDFDDDDDGDDD
DDWDDWWDDDDDDDDDDDDDDWWFDMDWDDDDDDDFWDDWWWDDIDDDFWDDDFWWDDDDDWDWDDDDDDDFWDDDWWDDFDWWDDFWWFDDDDDFDDDD
DWWDDDDDDDDDDDDDDDWWDDDDDDDDDDDDDDDDDDDDDDDDDDDDWWDDGDDDDDWDWDWWDDDDDDWWWWFDFWWWWWDDWDFDDDDDDDDWFDDD
DDDFIDDDDDDDDDGDDWDDDDDDDDDDDDDWWDDFDDDDIFDDDDDDDGFDDWDDDFDDDGDDDFDDDFWWDDDDDDDFWFDDWDDDDDDDMDDDFDDD
DDDDDDDDDDDDDDDDFMDDDDDDDDDDDDDDDDFDDDDDDDDWDDDDDDDWWWDMDDDDDDDGDDDDDDDDDDDFDDDDDDDDWWDDDDDDIDDDDMDD
DDDDDDFFDDDDDDDIDFDDDDDDDDDFDFDDDDDDDDDDDDDWDDDDDDDDDDDDDDDDWWFDWFDDDDDDIFDWWDWFWDDDDDIDDDDDDDWWDDWD
DWFDDWWFDDDFDDFDDGFDDDDDDDDDDWWDDDDDDDDMDFDWWFDDDDDDFMGDDDDDDDDDDDFDDDDDFIDWWDDDWDDDDFDDDDDFDDDDDDDD
DWWDDDDDDDFDDDDDDDDFDDDDWFDDDWDDDDFDDDDDFDDDWDDDMDDDDDDDDDWWDFWFIDDDGDDDIFDDDDDDDDFIDWDDWWDWWDDDDDDD
DDWWFDDFDDDDDDFDDDWWDDDFDDDIDMDDDDDDDDDWDDFWWDDDDDFWDDDDDDFDFDMDDDDDDDDDDDDFDDDDDDDDWWDFDDWFWDDDWDDD
DDFFDDDDFWWDDDDDDDDDDFIFFDDDDDDDDDFDDMDDDDWWDFDWDDDWFFDDDDDDWFDWWWFDGFDFDDDWWDDDDDDWDDDWDWWDDDFDWDDD
DDWWDDDWWDFDDDDWWDDDDDDWWDDDWWDDDDWWDFFDDDDDWWDDDDFWWWDDDDWWDDWWFDDDMDDWWDDDDDIDDFDWWDDWWWWDDDDDWFDD
DWDDDFWWFWWDDDDDDDDDDDDDDWWDDDDDDDDDWWWWDDDDDDDDDFIDDDMMFDDDWWDDDWDDDDDDDDDDDDDDFDDDDDWDIDWFDDDDWWWD
DDDDDDDDDDDDDDDDDDDDDDDDDDDDDDDDDDDDDDDDDDDDDDDDDDDDDDDDDDDDDDDDDDDDDDDDDDDDDDDDDDDDDDDDDDDDDDDDDDDD