;Map made by Santella Agustin
;element index
;  D : Diert
;  M : Mountain
;  W : Water

; starting the level:
DDDDDDDDDDDDDDDDDDDDDDDDDDDDDDDDDDDDDDDDDDDDDDDDDDDDDDDDDDDDDDDDDDDDDDDDDDDDDDDDDDDDDDDDDDDDDDDDDDDD
DDFDMDDDDDDDDDDDDDDDDFDDFDMDIDDDWWDMDDDWDWWDIDDDDFDDIFDDDDWWDWWDDDIDFWWWDDDDDDDDDDDDGDDFDDDDDDDDFDDD
DDDDDDDDDFWWDDDDDDDDDDDDDDDDDDDDDDDDDMDWDDDDDDDDDDDDDWDDDFWDDDDDDDDDWDWWDDDWWFDDDDDDDDDDDDDGDDDFDDDD
DDDDIDDDDDDDDDDDDDDDFDDFDDDDDDDDDDDDDFFWDWDDDDDDDDDDWWWDDWFWWDDDDFWDWDDDDDFDDDDDDDDDDDDDWWDDDDDDDDWD
DWDDDDDDDWDDDDDDDFDWWDDDDDDDDDDDDWWDDWDWDWWDDFDDDDDDDDDDWWDDDDDDIDWWWFDDDWWDDDFDDWDDDDDWWDDDDDDDDFWD
DDDDDDDDWWDFDDDDDDFDDDDDDWDDIDIFWDDDDDDDDDDMDDDDDDWWDDDDMDDDDDDDDDDDDDDFDDDDDDWWWWDDDDDDDDDDDDDDDWWD
DDDDDDWDDDMDFWWDWFDDFDDDDWWWFDDDDWWDDFWDDDDDWDDDIDFDDDDFDDDDDWFDFDDFWWFIDDDDDDDDDDDDFDDDDDDDDDDDDDDD
DDDFDDWDDDFDDDDDDIDDDDDDDDDWFDDFWWDDDWWDDDDDWFDDDDDDDDDWDWWFWWDDDDFWWDFDDDDWWDDDDDWFWWDDDDDDDDDDIDDD
DDDWDFWWDDDDDDWDDDDDFDDDDDDDMFDDDDDWDDDDDDDWWFDDDDDDDDFDDDDFDDDFIFDDFWWDDDDDDWDDFWWWWDDDDIDDDDFWDDDD
DDFDDDDDDDDGDFDFDDDDDDFDDWWDDDFWFDDDFDDDDDDFDDDDDWWFDDWFDDFDDDDDDDDWWDDFWFFWFDDDDDDDDDDDFDDDDDWWWWDD
DDDIDDDDDDDDDWDWWWDFDDDDDDDDDDWWDWWDDDFDDDDWWFWWDDDGFDDDDDGDFDGDDDDDDDDDDDFWWDDDDWDDDDDFGDDWFDDDDDDD
DDDDDIDDDDDDDDFDDWWWWDDWDDDGDDDDDDDDDDDDWDDDDDDWWFDDWWFDDDDDDDDWDDDFDDDDDDDDDWDWDDDDDDDDFWDDDDDDDDDD
DDDDWDDDFDDDDDDDDDDDDDDDDDDDWWFDDDDWWDFDDDIFDDDDDDDDDDDDDDDDDFDWWDDDDDDFDWFDDDDDDDDDDDDDDWWFDWWDDGDD
DDDDDDDDWDDDDDFDDDDFDDDDWDDDDWDFDDDDDDWWDDDDDDDDDDDWDFDDDDDDWWDDDWDDDDDDDDDIDDDDIDDDDDFDFDDDMDDDDFDD
DWWDDDDDWDDDDDDDDWWDDDDDDDDFDDDFDDDDDDFWDDDDDDWFFDDWFWDDDDIDWDDDDDDDDDWDDDDDDDDDDGDDMDIFWWDDDDDDDWDD
DDDDDWDFWDDDDDDDDDDDDDDDDWWWWDFWWDDDDFWWWDDDDDWWDDFWWWWFDWDDWDDDDDFDDWDDDDDDFDDFDDWWDDDMDDDDDFDDDWWD
DDDDWWWDDDDDWWDWDDGDWFDDWDDDDDFDDDFDIFDDDDDDWDDDDDDFDDDDFWDDMDDDDWWWDDWWDDDDDDDDDDDDDDDDDGDDWWDDDDWD
DDDDFDDFDFDDDDDDDDDWDDDDDDDDDDDDDDWFDDDDDWDDWWFDDDDDDDDDFDFDDDIDWDWDFWWDDDDDDFDWWDDDDDDDDDDDDDDDDDDD
DDIDWDDWDDDWDFDDDDDFWWFDDDDDDDDDDFDIFFDDDWWDDDDDIFDDDDDDDDDFWWDDDDWDDDDDDDIDWWDDDDFDDDDWWDDDDDFDDDDD
DDDDDDWWFDWWDDDDDDDDDDDDDDDDDDDDDDFDFWDWWDDDDDWWDDDWDWDDDDDDDDDDDDDDDDFDDDDDDDDDDDDDDDDDDDDDDFWFDFWD
DDDDDDDDDWDFDDDDDDDDDDWWDDDDWDDDDDDFDDDDDFDDDDDDDDDDDDDDDDGDDDDDDDDDDDIFDDWWFDDDDDDDFDFWWWFDDWWDDFDD
DDDDDDIDFWDDDDDDDDDDDDDDDDDDDDDDDDFWWDWDFWDDIDDFDDMDDDDDDDDDIDWDDDWDDDDDDDDDFDDDDDDDDFFDDDFDDDDDDDDD
DDWWDWDDDDDDDDDDDDDDDDDDDDFDDDWWDDFWWDDDDWFDDFDDDDDDWDDDDDWDDDDDDFWWDDDWWDDWWWDFWDDDWWDDDDDDDDDDDWWD
DWDDWWWDDDDDDDDDDDWDWWDDDDGDWWWFDDFDDDDDDWWFDDDDDDWWWDDDDFDDDDDDDDDDDDDDDDDWWDDDDDDDDDDDDDDDDFDDDDDD
DDFDDDDDDFWDDIDDDWWWDDDDDWFDDDDFDDWDDDDFDDIDDDWDDDDDDDDFDDDFDDDFDDDDDDWDDDDDDDDDDDDDDDFWDIFDDWDDDDDD
DFWWDDDDFFDDDDDIDFDWDDWWDWDDDDDWFWWDDDDDDDDDDWWDDWWWFGDDDDFDDDDDDDDDDDDDDDDDDDDDDDDDDDDWDDFDDDDDDDDD
DDDDDDFWWWDDFDDDWWDWWDDDDWWDDDDDDDDWWWDDDDDDDDDDIFDWWDDDWDDDDDDDDDDDDDDDDWDDDDDDDDDDDDWWDDWWDDDDDDDD
DDDFDDIDWWWDDDDDDDDFWWDDFWDDDDDDDDDDDWFDDDDDIFDWFDDDFDDFDDDDDDDIDDDDDDFDDMDDDDDDDFFWWFDDDDDMDWWDDDDD
DDWWDDFDDDDDDDDDDMDDDDDIDWDDDDDDDFDDDDDWDDDDDDDDDDWWWDWFDDDDWWWDWWDDDDDDDFWWWWDDDWDDDDDDDDDDDDDDDDDD
DIDWDDDDDMDDDIDFIDDDDFDDWWDDDDDDWWDDDDFWWFDDWWWDDFWDWDDDDDDDDDFWDDDDDDDDDDDWDDDDWDDIDDDWFFDDDDWWDDWD
DFWWWWDMDDDDDDWDDDDFFWDDDMDDWWFDDDDDDDFDDDDDDDDDDFDWDDDDDDDWDDFDWWDDDDDDDDDDDFDDDWDDFDDDDDFDDDDDDWWD
DDDDWWDIDDDDMDWWWDDDDDDFDFDDDDDDDDFWDDWDDDDDWDDDFDDDWFDDDDWWDWWWDDDDWDDFDDDDDIDFFDDDWWWDDFFDDDWDFWDD
DDWWDDDDDDDDDDFDDDDDDDFDDWDDDDDDWWWWWWWWFDDFWWWFDDDWWWDWDDDDDDWFDDDDWDDWDDDDWFDWWDDDDDDDDWWFDDWWDWDD
DWWDDDDDDDDWWFDDDDFDWWDDWWDGDDDWWDDDDWDDDDFWDWFWFDDGDDFDDDDDDDWWWFDDDDWWDMDDWWWDDDDDDDDDDDWWFDDDDDDD
DWFDFWDDDDDDDFDDDFDDWFDDDDDDDDFWWDDDDDDDDDDDDDDDDDDDWFDDFFDDWWDDDDDDFDDDDDDDDFWDDDWFDDDFDDDDDDWDIDDD
DWDDFDDDDDDDFDDFWWFWDDDWDDWWWDDDGDWWWDDDDDDDDDDIDDDWWFDDWWDWWDDIDDDWWWWDDWDDDDWDDDDDDDDDIDDDFWWDDWWD
DWWWDDDDDDDWWDDDDDDWWDWWDWWWWWDDFDDDDDDDDDWDWWDDDDDDDDWDDDDDDDWDWWWDDDDDDWDDDDDDDDDFDDDDDDFDDFDDFWFD
DDDDDDDDFDWDDDDDDIDDFWDDMDDDDDDFDDDDFDDDDDWDWWDWWWDIDFWWWDWWDDDDDDDDDDIFDDDDDDDDDDDDDDDDDDDDDWDDDDDD
DFDDDDDDDFWWDDWDDDDDDDDDFDDDDDDDDFDDDDDDDDWWDDDDFDDDDDDDDDDDDDDDDDDFDDFDDDDDDDDDDWDDFMIDDFFDDWDGDDDD
DDDDDDDDDDDDDDDDFDDDDDDDDDWDDIDDDWDDDIDDDDFDFDDDFDDIDDDDDWWDDDDDDDDDDDDDDDDDDDDDFWDMDDDDDDDIDWWDFIDD
DDDWFDDWWDDIFDMDFDDDDDMDWWWDDDDDDWDMDDDDDDDDDDDWWDDDDDDDDDDWDDDDDDDDDDDDDDDWDDWDDWWDDWDDDDDDDDDDWDDD
DDDDDDDDWWFDDDFFWWDDIFDFFDDDWWWWDWWDDDDFDDWDDDDDDDDDMDDDDDWDDDIDDDDDDDWWFFWWWDDIDDDDWWDDDDWWWDDDWWDD
DDDDDWWFDDDDDDDDDDDDDDFWWFDDDFDDDDDDDDDWFWDDDFDDDFDFDWWDIDFWWDFWWWDDDFDDDDDDDDDFIDDWFDWDDDDDDDDMDGDD
DDDFDDDDMDDDDDDDDDDDDDDDFWWWDDIDDDDDFDDWWDDDWWFDDDDWWFFWFDDDDFDDDDDDDDDDDDDDDFDDDDDWWDDFWDDDWWWDDFWD
DDMDDDIDDDWFDDDDDDDDDDDDWDDDDDFWWDDDDDDDDDDDDDDIDDDFWDDWWDDDDDDDFDDDFDWFDWFDDDDDDDDWDDDDWWDDDDWWDDDD
DDDDDDDDDDDDDIDDDDFDDDDDDDDDDDDDDDDDDDDWDDDDDDDDDDDDWDDDDFDWDFDDDDDFWDDDDDDDDDDDFDFWWDDDDDDDDDDDDDDD
DDDDDDDDDDDDDIDDDDWWDDDDDFDWDDDDDDDDMDDWFDDDDDDDDDFDDDDDWWDDFDDFDDDDWDDDDMDDDDFWWDGFDDDDDDFDDDDDDMDD
DFDGDDDDDDDDWDWWDDDDDDDDDDDWWFDDDDDDDDWWDDDDIDDDWWWFDDDDDDDDDDDDDDDDMGDWWFDDDDDDWFDWDDDWDDWDDDDDDDDD
DDDDWFWDDDDWWWDDDDDWWWFDDDDDDDDFDDDDWDDFDDFDDDDDFWWFDDFWDDWWDDDDDDDDDDDDDDDDDDDDDDFWWDFDDDWDDDFDDDDD
DDDDWWWDDDWDDDWDDWWDDDFDDDDDDFDDDDDDDDDDDFIDDGDDFDDWDDDDDDDDDWWDWDDDDDDDDFDDDDDDFDWDDFWDWWWFDFIDDDDD
DDDDDDDDDDDDDFGFDDDDDDDDDDDDDDDDDDDDDDDDDIFDDDDDDDDDDDDDDDDDDDDFGFDDDDDFDDDDDDDDWDDDDWWFDDDDWWDDDDDD
DDDDDDDDDFDDDDDDDDDDDDDWFDDFDDDFDDDFDDDDDDWDWDDDDFDDDDDDIDDDDDDDDDFWDDDDDDDFDDDWWWDWWDDDDDDWFDDDDDDD
DDDDDDDDDDDDDIFDDDDDDDDWDDDDDDDWWDFWFDFDWDWDWWDDDDDDDDFDFDDDDDDDDDDWWDDDDDFIDDWDDFWDDDIDDDDDDDDDDDDD
DDDFFWDDDDDFDDDDFDDDDDWDGFDDDDDDDDWWDDWWWDIFDWDDDDDDDDDDDDDDDDDDDDWWDDDDDDDDDDDWDDDDDDDDDDMDDDDDDDFD
DDFDDWWWDDDDDDDFWDDIFDFDDDDDDDWWWWWDDDDDGDDDWWWWDDDDDDDWWWWWDWDDDDDDDDDDDDDWWDDWWWDDDDDDDDIFDDDDFWWD
DDDMDDDDDFDDDDDDDDDFDDDDDDDDDDDIDFWWWWDDDDDDDDFDWDDDDDDFDDDFDWDDDDDDWDDDDDDIDDWWWDDDDFDDDDDDDDFDGFFD
DDDDDFWFDWWDDDDDDWFDFDDDDDDGDDDDDDDWDDDDFWWWDDDDWFFWDDDDDDDWDDDDWWDFDDDDDDDDDDIDFDDDDWDDDDDFDFDDDDDD
DDDDDDDDMDDDDDDDDDDDDDDDDDDDWDDDDDDDDDDDDFWWWWFDWWFDDDFFDDDDDFDDDDDDDDDDDWFDDIFDDDDFDWDFDFWWFDDMDGDD
DDDDDDFDDDFDIDDDDDDDFDDDDDDDWDDDDDDDDDDWWFDFWDDDDDDDIFWWDWDDDWWDDDDDDDWWDDDDGDDDDDDDDDDDDDWWFDDDDDDD
DDDDDDDDDDDDDDDDDMDDWDDDWDDDWWWFDDDIDDDDDDDDDDDDDDDDDDWDWWDDDDDDDDFDDWDDDDDFDDDDDWWFFFWWDDDDFDDDDDWD
DDDWWDDDDDDDDDDDDDDDDDFFDDDDDDDDDDDDWWDDDDDDDMDWFWDDDDWWDWWWDDDDDDMDDFDDDFDWDDIDWDDDWWWDDDDDDDDDDDWD
DWWDDDDDDDDDDDIFDDWFDDWWDDDDDDDDDDDDDDDDDFDDWFDDDDDFDDDDDDDDDDDDDIDDDDDDDDDDDDDDDDDDDDDDDDDDDDDDDDDD
DFDDDDIFMDDFDDDFWDWWDDDDDDDDDDDFDDDDDDDDFDDDDDDDFDDDDDDDDFDMDFDDDDDDDDDDDDWFMDDDDDDDDWWWDDDDDDDDDDDD
DDDDDDDDDWDDDDDDDDDDDFDDDDDDDDDDDDDDGDWWDDWFDDFDDFDDDDDDDDDDDDFDDDDDDDDDDWWDDDDDDDDDDDDDDDWDDDDWDDWD
DFDIDDDDDWDDDDFFDDDDDDDWDDDFDDDDDFDDDDIDDDDDWFDDDDDDWWDDDDDDDDDDDDDDDMDDDDDIDDDDGDWDDDDWDDWWDIFWWWWD
DDDDDDDDDWDDDFWWFWDDDDDWWDFDDDDDDWDDDDDDDDDDDDDDDDDDDDDDWWDDDDDDDDDDDDFWDDDDDDDDFWWFWDDWWDDWDDWWDDDD
DDDDFWWFDWWDDDDDFWDDWWFDFDDDDDGDWWWDMDDDDDWDDDIDDDDDFDDWFDDDIDDDDDWFFDDDDDDDDDMDWDDDWWDDDDDDDDDDDDWD
DDDDDDDDWWDDDDDDDWWDDDDDWWWDDDDDDDDDDDDDWWWDDDDDDDDDDDFWDDWDDWWWDWWDDDDDDDDMDDDDDWWDDDDDIFDDDFDDDDWD
DDDDDDDDDDDDFDDWDDWDDGFDDWDDDDDDDDDDWWFDDWFDDDDDDDDDDDDWWDDDWWDWDDDWWFDDDDDDDIDWWDDDWFDDFIDDDDDDDDDD
DDDDDDDWWDDDDDDMDWWDDDDFDDDDDDDDDFDDWWDDDDDDDDDDDDDDDDDDFWDDDDWWWDWDDDFDDWWDDDDDDIFWWDDWWDFDDDFDFWDD
DDDDDWWFDMDDDDDDFDDDWWFDDDWWDDMFWWWWDDDDDDDDDDDDDDDDDDDDWWDDWWDDMDDWDDDMFDDDDWWFDDDDDDDDDDDDDWWDDWWD
DDDDIDDDDFDDDDDFDDDDFWWDWWDDDDDFDDDDDDDDDDDDDIFDDDIDDDFDDDDDDDDDDDFWDDDDDDDWWWWDDFDDDIDDDMGFDDDDIFDD
DDWWDDWWDDDDDDDDDDDIDDDDDDDDDFWWDDDDDDDDDDDDDDDDDDDDDWDFDDFDDDDDDDWFDDDDDDDDFDDDDDIDDGDWDDDWWFDDDDDD
DDDMDDDDDDFDDDDDDDDDWDDDDDDDDDDDDDDIDDDDDDDDDDDDDDDDDDDDDWWDDDDDDDDDDWWDDFDWWWDDDDDIFDDWWFWWWDDDDDDD
DDDDDDDDDDDDDDDDDDWWDDDDDDDDDDDDDDDDWWWDDDDDDDDDFDDMDDDDDDDDDDDDDDDFWDDDDMDDDDDDDIDDDDMDDWWDWWFDWDDD
DDDDDDDDDDDDWWFDDDDDWWWDDDMDDDWFWWDDDDDDWFDDFDFDDGFDDDMDFDDDDDDDDDDWWDDDDFWDDDDDDDDWWFDWWWWDWWFWWDFD
DFDDDDDDDDDWFDDDWWDDDFWDWDDDDDWDDDDFDDDFDDDFDDDDDDDDIFDDWDDDDDDDDDDFDDDDDDDDFDDDDDDDWWWDFDDDDFDDDFWD
DDFDDDDDDDDWWWDDDDDDDDDDWWWDDDWDDDFWWDDDDDDDDFFWWDDWDDDDDDDDDDDDDDWWDDWDDDDDIDDIDWDDDDDDWWWWDIFDDDDD
DDDDDDDFDDDFDDDDDDDDDDDDDWDDDFDDDFDDDWWDDFDDWWDWWDDWDDFDFDDFDDDIDDFDDDWWWFIDDDDDDDDFDDDWDDFFDDDDWWDD
DDDDDDDDDDDDDDDDDDDDDDDDDDDDDDDDDDDDDDDDDDDDDDDDDDDDDDDDDDDDDDDDDDDDDDDDDDDDDDDDDDDDDDDDDDDDDDDDDDDD