;Map made by Santella Agustin
;element index
;  D : Diert
;  M : Mountain
;  W : Water

; starting the level:
DDDDDDDDDDDDDDDDDDDDDDDDDDDDDDDDDDDDDDDDDDDDDDDDDDDDDDDDDDDDDDDDDDDDDDDDDDDDDDDDDDDDDDDDDDDDDDDDDDDD
DDDDDDFDDDDDDDDDFWWDDWWDDDDWWFIDDWWDDDDDFFDDDDDDDDDDDDDWWFFDDDDFFWWFDFWWWFDDDDDDDDDDDDDDDDDDDDDDDDDD
DDDDDDDDDDDDDDDDDDDWWDDWWDWWDWDWWDFDDDDDWWDWWDDDDDDDDDDWWWWDDDDDDDDDDDDDDWDDDDDDDMDDDDDDFFWWDDWWWDDD
DDDWWFDDDDDDDDFWWDDDDDDFDDDFWDDDDFWWWFDDIDDDDDDDDDDIDDDDDDDDDDDDDDDWWWDDDWWDWWDDDFDDDDDFWWWWWDDDDDDD
DWWDDWDDDDDDDDWDDDFDDDDDDWWDDDFFDMDWWDDDDDDDFDDDFDDDWWDIDDDFDDDDDDDDDDDDWWDDDIDWWWWFWWDDDDDDFDDFDMDD
DDDWFDDDWFDDDFDDDDDDDWWDDDDDDDWWDDDMDDDWDDFWWFDWWWDWWWFDWDDDDDDDDDWWDDDDDDDDDDDFDIDDDDDDDDWWDDDDDDDD
DDDDDDWWDWDWWDDDDDDFDDDWWWDFWWDFDDDDDDFDDGDDDDDDFDDWWDDDWDDDDDDDDDDWWWWDDDWDDWDDDDDDDDDDDDDDFDDDWWDD
DDDDDDDWWWDDDDDDDDDDDWWDWDDDFWWWDDDDDDFDDDDDDDDWWWDDDWDDDDDDDDDDDDDDDDDDDDWDDWWDDDDDDDDDDDDDWDDDDDDD
DDDGDWDDDFWFDDDDDFDDWWFFDDDDDDDDDDIDDDDDDDWWDDDDDFDDFWWDDDWDDDDDDDDDDDFDDDDDDDDDDDDDFDFDDDDDDDDFDDWD
DDDDDDDDDDWWFDDDDDDWWDFDDWWWWDDDDDDFDDFDDDDDWDMDDDDDDDDDDWDDDWFDDDDDDDWWDIDDDDDDDDDDDFDDDDDDFDWWDDDD
DDDDWDDDDDDDDDDDDDDDFDDDDWDDDFWWWFDWWDWFDDDDWWDDDDDDDDDFDDDDWWWFWWFDDWDFWFDDDDDDDDDDDDDDDDDDDDDWDDDD
DWWDDDDDDMDWWDDDDDDDDDDDDWWDDDDDDDDDWWWDDDDDIDWFWWDDDDDDDDDDDDDDDWDDDDDDWDDDDDDDDDDDDDDDDDWFDDDDDDDD
DDDDDDDDDDDDDDDDWWDDDDDDDWWDDDDFWDIDWDDDDDDDDDWWFDDDDDDDDDDDDDWDDDDDDDDDDDDFIFDWWFDDDWDDFDDDDDFDDFDD
DFDWWDDDDDDDDDDDDDDFDDDDDDDDDFFWWDDDDWWDDDDDDDDDDFDDDDDIDDDDWDDDWDDFDWDDDDDDDDDDDDWWDDDDWDDGDWWWDDDD
DWWDFDDDIDDDFDDDDDDWDDMDDDDDDGDMDDIDDDWWDDDFDDIDDDDDDDDDDDDDDDDWWDDWDDDDDIDDDFFDDDDWDDDWDDDFWWDDDDDD
DDWDWWDDDDDFWDDDFDDWWDFWDDDDDDDDIDFDDDDFDDDWWWDDDDDDDDDDDDDDDDDDDDWWDDDDWFWWDWDDDDWWFDWWWDDDDDDDDDDD
DWWDDDDDFDWWWDFWWDDIFDDWDDDFDDDDDWDDDDDDDWDDWWDWWWDDDDDWDDDDDDDDDDDDDWDWWWDDWWDDDDDDDDIDDDDWWDDWDDDD
DDDDDDDDDDMDDDDDIDDDDDWWFDDWDFWDDWDDDFWDDDDDDDDDDFDDDDWWWDDDDDDDDDDDDDDDDFDFDDDFDDDDDDDDDMFDDDWWDDDD
DFDDDDDDMDDDDDDDDDDDFIDDDDDWWDDDDDDDDDWDDDDDDWWDWWDDWWWDDDDDDDDIDWDDWDFDDDDDDDDWWFDDFDFDDDDDDDDWWDDD
DDDFDDDDDDDDDDDWDDDDDDDDDFDDDDDDDDDFDDWWFDWWWWDDWWWDDWWDIDDWWDDDDDDDMDDDDDFWWWDDDDDDDDWWDDDDDDFFDDDD
DDDWDDDDDDDDDWDDFDDDDDDDFDDFDDDDWWFDDDDDDDDFDFDIDDDDDIDDFDDDDDDWDDDDDDDDFWDDDFWWDFDDDDDWFDDDDDWWDDDD
DDDWWFWDDDDWWWWDWWWDDDDDDDDWWDDFWWFDDDMDDDDWFDDDDDDMGDDFDGFDDDDDDDDDDDDDDDDDDWDDDDDMDDDWWFDGDDDDDIDD
DDDDDFDDDDIDDDDDFDDDDDFWWWWFDDFDDFWDDDDWFDDDDDDDDDDDFWWFDFDFFDDDDFDDDDDDWDDDFWWDDDDDDDDFWDDDDGDGDDDD
DDDDDDDFDDDDDDDFDDDDDDIFDDDFDFWDDDWWDDDDFDFDDDDDDWDDDWWWDDDWWDWDFWDFDDDWWFDDDDDGDGDDFDDWWDDDDFDDWDDD
DWWDDDFDDDDDDDIDDDDDDIFDDDWDDDWWDDWDDDDDWDDMDDWWDDDDDDDDDDDDDDDDWWDDDDIFDDDDFIDDDDDDDDDDDDDDDWWWWWWD
DDDDDDIDDDDDDDDDFDDDWFDDIDWWDDDDDWDDDWDDWWDDWWDDDFWDDDDFDDDDDDDWWDDDWFDWWWWWFDDDDDDDFDDDDDDDDFDDDFDD
DWWDDDDWDDDWDDDWWDDDDDDDDDDDDDDDDWWFFDDDDDDDDDDIDWWDDDFDDDDFDDDDDDDDWDDDDDDDIDDDGDDDWDDDWDDDDDIFDDDD
DFIDDDDDFWWWWDDDDDDDDWDDDDDDDFDDDDDIDDDDDDFDDDDFWWFDDDDDDDDDDDDDDDDWWWDDDDGDDDDDMDDDWWDFWWDDDDDDDDDD
DDDFDDDGDDDDWWDDDDDFDDDDDDDDWWDDWWFDDDMFDFDDDDFWDDGFDDDDDWFDDDDMDDDDDDDDDDDDDDDDDDDDDDDDDDWDDDFDDDDD
DDDDDDDDDDDDDDIDDDDWDDWDDWWWWDDDDFDWWDDWFFDWWDWWDFDDDDFDWWWDDDDDDDDDDDWDDDDFDDMDDDDFDDDDWDWWDWWWDDMD
DDDDWDDDDWWDDDDDDFWWDDWWWDDDDDDMDWDFDDDDDWWDDDDDDWFDDDDDDDDMDDDDDDDDFWWDIDDGDDDDDIDWDDDWWWDDDDFDDDDD
DDDFDDDDDDDDDDDFWDDDDDDFDDDDDDDDDDDWWDDDFDIDDDDDFWDDDGDDDDDDDDDDDDDDDDDDDDDDDDDDWDDDDDDDDWDDDDDDDDDD
DDDDDFDDDDDDDDDDWWWWDDDDDDDDDDDDDDWDDDDDDDDDFWFDDWDDDDDDDDDDDDDDMDDFDDDDDDDDWWWFWDWDDDDDFDDDDDIDDDDD
DDDDDDDDWDDDFDGDDDDDDDIDFDDDDDDIDFWDDDWDDDDDDDGFFDDDDDDDWDFDDDFDDDDWDDDDDDDDDDDDWDDGFWWWDDWFDDDDDDDD
DDDDDDDWWDDIFDGDDDDFWDDDDDIDDDWDDDDIDDWDDWWWWDDDDMDDDDDDDDDDDDDDDDWDDDFDFDDDDDDDDDMDWWDDDDWFWDDDDIDD
DDDDDWWDDIDDDDDDDDWWWDDDDDDDMFDDDDDDDDWWDDFWWDFWFDDDDDWDDDDDDDFDDDDDDDWWWWDDDDDDDDDWDDWWWDWWWDDDDDDD
DDWWWDDDDDDDDDDDDDWDDDMDDDDDDDDDDDDWWDDDDFDDFFWDDDDDDDWWFDFDDWWFDDDDDDWDDFWDDDDDDDDDFWDDDDWDDDFDDDDD
DWDDDDIDDDWDDDDDDFWWDGDDFDDWWWDWWDDDDDDWWWDDWWDDDDDIDDDDDDWWDWDDDDDMDDDFDDWWDDDDFDDDDDDDDDDDFDDDDWDD
DFDDDDDIDDDDDDDDDDDDDFWDDDDDDDDDDDDDDWDDDDDDDDDDDDDDDDDDDDWWDWWFDDDDDDDDDDDDDDDDWDDDDDDDDDDDWDFWWWDD
DIDFWWWFDDDDDDDFWWDFDFDIDDDDWWDDDDDDWDWWFDDDDIFDFDWDDDDDDDDDDDFDDDDDDFDDDDDDDDDDWDDDDWDDWWWWWDDDWDID
DDDDDDDDDDDDDDDFDFDDDWFDDDDDDDDDFDFDDMFWDDWDDDDDDDDDDDDDDDDDFDDDDDDDFDDDDDDDDDDWDDDWDDDWWDDDDDDDDDDD
DDDDDDDDDDDDMDDMFWDDDDDDDDDDDDDDDDWDDDDDDDWDWWWDDWDDWWDMDFWDDFDWWDDDDDDDDWFDDGDDWFDDDDDDDDDDDDDDDDDD
DDDDDDWWDDDDFWWDWWWDDDDFDDDDDFDDDWWDDIDDDDWWDDDDDDFDDDDIDDDDFDDDDDDDFDDWDWWFDDDWWWWDFWDFWDDDDDDDDDDD
DDDDDDDIFDDDDDDDDDDDDDFWDDDIFDFDDDDDDDDDDDDDDDDDDDDDDDDDWDDFDDDDDDDDFDDWWDDDDDDDDDDDWWDDDDDDDDDDFDDD
DDDDFDFDDDDDDWDDDDDWWWFDFFDDDDDDDDDMDDWDDDDWDDWDDDDDWWDDWDDDDDDDDWDWWDFDWDDDDDDDDDDMDDDWDDFDDDDDWWWD
DDDDFDWFDWWDDDDDMDDDDDDDDDDDDDDDDDDDDDDIFWWDDDWWWDWDDDDDDDDDDDDDWWWFDDMDDDFWDDDFDWDDDDDDDDDDFDDDDDDD
DDDDWWWFDDDDDDDDDDDDDDDDDDDDDDDDDDDDDDDDDDWWWDDDDDDDWWDDDDDDDDWDDDDDDDDDDWDDDDDDDWWWFDIDDIDDDDDFDDDD
DDDIFDDDDDDDDDDMDDDDDDDDDDDDDDDDDDDDDDDDWWWFFDDDDDDFDMDDFDDDDDDDDDDDDDDDFWFDDDDFDDDMDMDDDDGDDDWWFDDD
DDDDDDDDDDDDDDFDDDDDDDDDWWWDDDDDDDDDWDDDWWWWWDDDDDMDDDDDWDDDDDDWFDIFDDDDDDDDDDDWWWWDDDDDDDDDDWWFDWDD
DDDDDDDDDFDDDFWWWDDDDDDDDFDFWWDWDDDWWFDDDDDDDDWDDDDDDFDDWWFDDDDWDDDFDDDDDDDDDFDDDDDDDDDDDDDDFDDDDWDD
DDDDDDDDWWWDWWDDIDDDDDDDDDDIDDFDDDDDDDDDDWWDDDDDDDDDFWFFDDDDWDDDDWWWDDDDDIDDFWWWDDDDDDDDDDDDDDDDDDFD
DDDDDDDDDDDDDDDDFDIDFDDDDDDDDDDDDDGDDDDDDDWWDDFIDDDDDDDDDDDDDFDDDDDDDDDFDDDDFDWWWDDDWFWWDDDDDDDDFDWD
DDWDDDDDWWFWWFDFDDDDDDDFFWWDDWDDDDDDDDDDDDWDDDDIDWFDDDDDMDDDDDGFDDFDDDFDDWWFDDDDDFDFWDWWDWDDDDFDDFDD
DDDDDDMDDFWDDDDDDDFDDDDWDDDDDWDDDDDIFWWWDDFDDDIDDWWDDDDDDDDDDFDDDDWWDDDDDDDDDDDFDWDDWWDDWWWDFWWFDDDD
DDDDDWFDDDDDDDDDDDDDDWWWDDDDDDIDDDDDDFDDDDDDDDDDDWDDDDDDDFDDWWDFDDFDDDDDDFDDWWWWDDFDDDDDDDDDDDFDDFDD
DWFDWWDDDDDDDDDDDDDDFDDDDDDDDDDDDDDDDDDDMDDDDDDDDWWWDFDDDDDDDDWWWDDFDDDDDWFDDDDDDDWWDDDDDWFDDDDDDDDD
DWWFDDDDDDDDIDDMDDDDDDDWWDDDDFWFDDWDDDDDDDDDDDDFDDDDDIDDDDDDDDWWDDFDDDWWDDDDDDDDDDFDFFDFWWWFDDDDDFWD
DWDDDDDDDDDDDDMDDDDDDDDDDDDDFFDDDDDDDWDWWWFDDDDDDDDDWDFDDFDDDDDDDDDDFDDDDFDDDDDDDDDDDDDDWDDDMDDDDDDD
DDDIFDDDDDFDDFDDDDWDWDWWDDDFWFDDDDFDDWWDDDDDDDDDDDDDWWWDDDDDDDDDDDWWWFDDDDGFFFDDDDFGDWWDDDDDDDDDDWDD
DDDDDDDDDDDDDWFDDDWDDFWDDDDDDIDDFDWFDDIDDDDWDWWDDDDWDDDFDDFDDDDDDWWDFDDDDDDWWWDDWDDDDDDDDDDDDDDDDWDD
DIDDFDDDDWDDDWWWDDDDDDDDDDFDDDDFDDWWDDIDDDDDDDDDDDDDDDDDDDDDDWWFDIFDIDDWWDDDDDDDWDDDDWDDDDDDDDDDDDDD
DDDDGDDDFDDDDDWDFDDFDDDDFDDDWWDDMDDDDDDDDDDDDFDDDDDDDDDDDDDDDDDDDDDDFWDDFDDDDDDDMDDDDDDDDDMDDDFWFFMD
DDDDDGFDDDDDDFWDDDDDDDDDMDDFWWDMDDDDDDDDDDDDDWDDDDDDDDFDDDDDDDDDDIFFWWDFDDDDFDDDDWWDDDIDDDDDDDFWFDDD
DDDDDDDDDFDDDDDDDDDDDFFDDDDDDDDFDFDDDDDWWDDDDDDDDDFDDDDDFDDDDDDDDDMMDDFDDWWWWFDDWWDDDDDFDDDFWWDWWWDD
DWDDDDDDDWWDDDDDDDDDDWWDDDDDIDDDDWDWWDDIDDDDDDDDDFDDDDDDDDGDDDDDDDDDDDWFDDDDDDDDWWDDDDDDFWWFDWWDFDDD
DWWDWDDDDDDDDDDDFDDDDWDDFDDDDDDDDDDDDDDFWWDDDWDDDDDWWDDDDDDDDDDDDDDDFWWWDDDDDDDFDDMDDFDDDDDFWDDDDDWD
DDDFDDWDDDDDDDDDDDDDDWWDWWDDWWDWFDDDDFDDDDDDDWWFDFDDFMDFDDDDFWDDDDDDFDDDDDDDDWWWWWFWWWDDDDDDWWDDDDDD
DDDWFWWFDDFDDDDDDDWDWWDGDDDDDDDDDDDWDDFFDDDIDDDDDWWDDDDDDDDDWWDDDDDDDFIDDFDDDDDDDDDWDDDIFDDDDDDDDDDD
DDDMDDDFWWWDFDIDDFDDDDDDDDDDDDDDDDWWDDWWWDDDDDFFDDFDDWDDDWDDDDDDDDDDDDDDDDFDMGDDFMDWDDDDDWDDMFDDWDDD
DDDDDDDWDDDDWWDFWWDDDDDDDDFWWFDFDDDFDDMDDFDDIDWWFDWWDDDDWWDDDDDDDDFWDIDDDDDDDDDFDDWWDDDFWWDWDWDWWDDD
DDDFWWDWDDWDDDDDDDDDDDDFDDWWDDDIDDFDDDDDFDDDDDFDDDWWDDMFDDMDDDFDDDDDDDDDFDDDDDDDDDDDWWDWDDDWWWFDDDDD
DDFDDWDDDDDDDDDDDDDDDDDGFDDDDDDDDDDDDFDDDDDDDWWWFDDWWWDDDDDDFWWDIDDDDFDDDDMDDDDDDDDFDDDDDDDDDDDDDDDD
DDDDWWWFDDFDDDDGDDFDDDDDIDDDDDDWDDDDDDDDDDDDDDDDFDDDDDFWDDDDDDIDDGDDDWDDDWDDDDDDFFDWWDDDDDDDDDDDDDDD
DGDDDDDDDWWDDDDDDWWFDDFDIDDDDDDWDDDDDDDDDDDDDFDDDDDDDDWWDDWWDDDDDDWWDWWDFDDDDDDDWWFDDDDFDDDWWDDDDWDD
DDDDDDDFDDWDDDDDFWDDDDDDFDDDDDDWWDWWDDDDDFWWWFDDDDDDDDDIDDDDDDDDDDDFDDDDDDDDDDDDDFDDWWDDDDDIDDWDWWDD
DDDFDMDDMFWDFDDDWDDDDDDDFDDFDDDDDFWDDDFDDDDDDDDDDDDFWDDDDDDDDDDDDDDDFMGDDDDDDDDWDDDDFDDDDDDDDWWFDWWD
DDWWDDDDDDWFDDDDDWDDDDFWWDFDDDDDDDDWDDDDDDDDFDDDDFDDWDDDDDDIDDDDDWDDDDDDDDWDDDDDDDDDDDDDDDDDDDDDDDDD
DDDDWFDDDDWWDDDDDWWDDDDDDDDDDDDDDDDWDDDDWWDWWDDFDFDDDDDDMDDDDFWDDWFDDDDDDWWDIDDDDDDGDWWDDDDDDDDIDDFD
DDDFWWDDDDFDDMDDDDDDDDDWWWFDDDDDDDDWWDDDDDDDDDDDFDDDDDDDDDDDDDDDDDDFDDDDGDDWDDDDWWDDFWFDDDDWFDDDFWWD
DDDDDDDDDDDDDDDDDDDDDDDDDDDDDDDDDDDDDDDDDDDDDDDDDDDDDDDDDDDDDDDDDDDDDDDDDDDDDDDDDDDDDDDDDDDDDDDDDDDD