;Map made by Santella Agustin
;element index
;  D : Diert
;  M : Mountain
;  W : Water

; starting the level:
DDDDDDDDDDDDDDDDDDDDDDDDDDDDDDDDDDDDDDDDDDDDDDDDDDDDDDDDDDDDDDDDDDDDDDDDDDDDDDDDDDDDDDDDDDDDDDDDDDDD
DDWWWFDDDWWWDFWDDDDFDDDDDDDDDDDDDDDDDDGDDDMDDDIDDGDDDDDDDFDDDDFDDDDDDDDDDFWDDDDDDDDDDDDDDDDDDFDDDDDD
DWDDWFDDDDDDDWWFDDWWFDDDFFDFDDDDDDDFDDDWDDDDDDDDDDWDDDDDDWFDDIDDDDDDWWDDDWWFDDFWWDDDDWWDDFDDDDDDDDDD
DDDDDDFDDDDDDDDIDDDDDDWWWWDGDDDDDFWWDDWWDDDWDDDDDDDFDWWDDDDDDDDDDDGDIDDDDDDWDWDDDDDFDDDWWDDDDFFWWDDD
DDDDDDIDDDDDMDDFDDDDDDDDDDMDDDDDDDWDDDDWWDDWDDWWWWDDDDDDDFWWDDDWWDDDDDDDFDDWWWDDDDDFDDDDDIDDDWWWDDDD
DDDDDDDFDFDDFIFDDDDDDDDDDDFDFDDDDDFDDFWDIDFWWDDDDDDDDDDDDDDIDDDDDDWWFDDDDDDDDDDDDDDDIDDDDDDDDDDDDDDD
DDDDDDFDDIDDDDDDDDDDDWWFDDDDDDDDDDDDDDDDDDDDDWWWWFDDIDDDIDDDDFDDWDWFDDDDDDDWWFDDDDDDDDDDDIDDDDDDDDDD
DDDDDDDDFDDFDDWDDDDDDDDWWDDIFDDDIFDDDDDDDDDDDDDDWWDDFDMDDDDDDDFDDDDDDIDDDFDDDDDDDDDDDDDWWDDDDDMDDWWD
DDDDDDDDWWDDDDWDDDDDDDDDDDDDDDFIDDDDFDDDDDDDDDDMDDWDDDDDWFDDDDDDDDDDDDDDDWDDWWDDDDDDDDWDWDDDDDDGDDDD
DDDDDDDFDDDDDDWDDDFDDDDFDFWWDDFDDFDDDDDDDDDFDMDDDWWDDDFDWWDDDDDFDDDDDDWWDWDDDDDDDDDDDWWFWWDDDDDDDFWD
DDDDDIDDDDWFDWWWWDDDDDDDDGDDDDDDDDFDDDDWWWDDDDDDDDDDDDDDDDDDDDDWDDGDDDDDDWDDDDDFWWWDDDDDDDDDDDDDWWWD
DDDDDDWDDFWWDDDDDDGDIDDFIDDDMDDDDDDDDDDDDDDDDDDDDDDDDDDDWWDDWWDWWFFFDDDDFWFDDDDDGDDDDDDDDDDGDDDDDDDD
DDDDDDDDDDDDDDFDDDFDDDWWDDDDFDFDDFDWFFDDDDDFDDDDDDDWWWWDDDDDDDFDDDWWFDDDDDDDDDDFDWWFDWWDDDWFDDDDFWFD
DDDDDDDDDDDFWWWFDDMDIFDIDMDDDDWWDDDDFWDDDDDDDDDDDDDDDWDDDDDDDDDDDDWWDMIDMDDDDDWWDDDDDDDFDDWWDDDDFWDD
DDDDDDDDDDDDDDFDDDFDDWWFMDWDDDWDDDDDDDDDDDGDIDDDDDDDIFDDWWDDDWDDWDDDDDDDDDDDIDDDDDDDDDDWWWWDDDDDDWWD
DFDDDDDDDDMDDDWWDDDDDDDFDDDDDDWFDDDDDDDDDDDDDDDDDDDDDDDDDDDDDWWWWDDDDDDDDDDIDDDDDDDDDDDWFDDWWFDDDDDD
DGDDDDDDDGDDDFDWWDDDDDDDDDDWDFDDMDDDDDDDDIDDDDDDDDDDDWWDDDDDDDDDDDDFDDDDDMDDDDDDDDDDWFDFDDDDDDDDDDDD
DDDDDDWWDDWWWWFDDDDWWDDIFDWWWWDDIDDDDFDDDDDDDDDDDFDDDWFDFWDDDDDDDDDDDDDMDFWWDIDDDDDDDGDDDDDFWWDDDDDD
DDIDWWDDFWWDFDWWDDDWFDDDDDDDDDMDDFDDFDDDDWWFFDWDDDDDDDDDDDDDFDDDDDDDDMDIDDWWWDDDDDDMDDDDDDDDDIFDDDDD
DMDWWWWDDDDWWFDMDFDDDDDDDDDDDDDDDDDDDDDDDDDDDDDDDDDDDDDDDDWWWDWDDDWFDDDDDDDWDDDDDDDDDDDWDDFDIDDFWDDD
DDDDDDDDDDDDDDDDDWDDDDDDMDDDWWDDDDDDDDDDDDFDDMDDDFDDDDDDDDDDDFWFDFWDDFDDDDDWDDDDDDDDDDDDGFMIFDDDDDFD
DDDDDWDMDDDDDDWWDWDDDDDWFDFDDDDFWFDDFDDDDDWWDDDDDGDDDDDDDWWFWDDDDDDFDDDDDMDWWDDIDDDDDWDDDDDDDDDDDDDD
DDDDDIDDFDDDDFFDFWFWWFDWFDDDFFIFDMDDDDIDDWFDWWDDDDIDDDWDDWWFWFDDDDDDDDFDDDDDDDDDDWDWWWDDDDDDDDDDDDDD
DDMMDDDDDGDDWWDFWWWDDDDWWWDDDDDDDDWDDDDDDDDDDDDDDDDDDWWWDDDDIDDDDWDDDDDDDMDDFWWDWWWDDWDDDDDDDDDDDDDD
DDDDWDWWWDDWWWFWWDDDDDDDDDDDDDDDDDWDDDDDDMDWDDWDDDDDDDDDDDDDDDDDDDDDDDDDWFDDDDDWDDIDWWWDDDDDDFDDFWDD
DDDWWWWDDDDDDFWWDDDDDDDDDDDDWDDDDDWWFDDWDDWWDWWDDDDDDDDWWDFWWDDDDDDDDDDDDDDDDDWWDDFWWDWDMDDDDWDMDWWD
DDDDDDWDDDDDDWWDDWDWDDDFDDDWWDDFWDDDDDDWDDDDIDDDDDMDFDDDDDDDDFWWDDDDDDDDDFDDWWFDDFDDDDDIFDDDDWDFDFWD
DDDDDDWDDDDWDDDDDDDWWDDDDDDDFDDDDDDDDDDDDDDDFDDFDDDDWDDDDFDDDFGFDDDDDDDDFWFDDDDMDDDDDDDFDDDDDDDDDDFD
DDDFFDWDDIDDDDWWDDDFDDDMDFDDMDDDDDDDDDDDDDDDIDDDFWDDDDWWDWFDDDDDDFWWDDDDWWFDDDDDDDDDDDDDDDDIDDDFDDDD
DDDWWDDDDDDDDFDDDDDDDDDDDDDDFDDDDDDDDWFDDDDDDDDDFWDDDDDDFDDIDDDFWDFDDDDDDDFDFDDDDDDWWDDDDDDDDDDDDDDD
DIDDDDDDDDDDDDDDDDDDWDDDDWWWWFDDWDDDWDDDDDFDDDWDDDDDDDDDDDDDMDDDWDWFDDDFDDDFDDDDFIDDDDDDDDFWDDDWDDDD
DDDDDDDDDFDDDDDDGFDWWDDDDDFDDDDDWDDFDDDIDDDDDDDDDDMDDWWDDDDDDIDDDDWWDIFDDGDDDDDDDDDDDDDDDDFWWDDWDDDD
DDDWDWFDDDDFDDIDDDFDDDFDFWWDDDDDDDDWWDDDDDMDDDDDDDDWDDDDDDDDFFDDDDWWDFDGFDDDDDDDDDDDDDDDDDDDDDFDDDDD
DDDWDWWFDDWWDWDDFWWWDWWDDDWWFDDDDDDDDDDDFDDDFDMDDDDWDDDDDDDDWWDDDDDDDDDFDDDDDDDFDDDDDDDDDDDDWWWDDDDD
DFWWWDDDWWDDWWWWDDDDDDDDDDDWFDDDDDDDDDDDDDWWWDDDFDDWDDDDDMDDDDDDDDDDDDDDDDFDDDDDDDDDDDDFDDDDDDDDDDWD
DFWDDDGDDDDDDDDDDDDDDDDDDDWWWDDDIDDDDDDIDDDDFDWFDDDDDFDDMDDDDDDDDDWDDDFDDDDGDDDDDDDDDMDDDMDDDDIDDDDD
DWWDDDDFDDFDDDDDDDDIDDDDWFDDDDFDDDDDDDDIDDDWWDWWDDDDDDGDDDDWDDDDDDDDDWWWDWDDDDDDDDDDDDWDDDDDDDFDDDID
DDDDDDWWWDGDFIDMDDDFWWFDDDWWWDWDDIDDDDDDDDDDDMDDDDDDDDFDDDWWDDDDDDDDDDFDDDDDDDDDDDDDIFWWWDDDDIDDWFDD
DFWWDWWDDDDDDDDDDDDDDDDDDIDDDDWWWDDFWDDDDDDDFDDDDDDDIFDDDDDDDDDDDWDWDDDDDDDDIDDDDDWDDDDDDDDDDDFWWDFD
DDDDDDDWWWDDDDDFDDDDDDDDDDDFDFFWWDDDDDDDDDDDWWDWWDDDDDDDDDDDDFDFWWDDDDDDDDFWDDMDDDWDDFDDDDDDDDDDDDDD
DDDDWWDDDDFDDIDDDDDDDDDDGDWWWWDDDDFDDDGDDDWWWDDDFDDDWWWFDDDDFDMDDDDDDFDDDDFDDDDDDDWWDWDDGFDFDDDDDDDD
DDFWDDDDDFDDDDDDWFDDDDFDDDDDDDDDIDWWDDMDDDDDDDDDDDDDDMDDDFDDDDDDDDDFFWDDDDDDDDDDDIDDDWDDDDDDDDDDWDDD
DDIFDDWFDDDDDDFDDDDDDDDFWDWWDWDWFDDWWDDDDDDDDDDDDDDDDDDDDDDDDFDDGDDDDDDDDDDDDFDIDDIDDDDWWDDFDDDDDDDD
DDDWDDWDDDDDDFWWDDDDDDDWWDDDDWWWWFWDFDDDDDDDDDDDDDDDDDDDDDDWFDDDDDDDDDFDIDDDFDGDWDDDDDDDDFWWDDFDDDDD
DDFWWDDDFWWDWWDDGDDWDDDDDWFDFDDDDDDWWFFDFFDDDDWWDDDFFDDDDDDWWDDDDDDFDDWWDDDDDDFDWDDDDDDWWWDDDWWDDDMD
DDMDDDDDDDDDDDDGDDDDDWWDDDDDDFDDDDDDDDDDWWFDDDDDFIDWWDDDDDDDGDDWDWWDFWWWFWDDDWWDWDFDDDDFWWWDDDDDDDDD
DDDDDDMFDDDDDIDDDDDDDDDDDDDDDDDWWDDFDDDDDDFDDWWDDDDDFWWDDDDDDWFWDWWDDDDDDWWDDDDDDIDDDDMDDDDDWWDDFDDD
DDDDDGDWWDDDDDDDDDFFDDDDDDDDDDDDFDDWWWDDMFDFWWDDGDDFWDDDDDWDDWDWFDDDDDWWDDFDDDDDDDWDDWDDDWWDDDMDDDDD
DDDDDDDDDDDDDDWDWWWWDMDDIDDMDDDWWDFDDDDDDDDWWWDDDDWDDDDDDWWFDDDWWFWWDDDDDDDDDDFDDDDDDDDDDDDDDDDDFDDD
DDDDDWDDDDWWDDWDDDDDDIDDDDDDDDDDDDIFDDWDDFDDDFDDFWWDDDDDDDDDDDDDDDDWWDWWDDFDDDWDWWDDDDDDDFWWDDDDDDDD
DWWDDDDFDDWWDDDDDDDDDDDDDDDDDDWWWDDDDDWWFDDDDDDWWDDDDDDDDDDDDMDDDDDDDDDDDDWDDFDDDDDDDDDDDIDDIDDFDDID
DFDDDDWWFDFDDDDFDDDWDFDDDMDFDDDDIDDDDDDDDDDDDDWWDDDDDDDDDDDDIDDDDDDDWWDDDDDDDDFWWFDDMDDDDDDIDDDDDDDD
DDDDDDDWWDDDDDDDDDFWDDDDDDWWDDDDDDDDDDDDDDDDDDDDDDDDMDFWWFFDFDDDDWDDDDDWWFDDFDWDDDDDDDDDDDMFWFDDDDDD
DDFDDDDDDDGFWDDDDDWWDDIDDDFDDDDDWWFWWWDDDWDIDDDWDIDDDDDDDDDDDFDDDDDDWDFDDDDDDDDFDDDDDIFDDDDDDDDDDDDD
DDDDDMDDDDGFWWDDDDDDDMGDDDDDWDDDWWDDDDWDDWDDDDDDDDDWWDDDDDDGDDFDDDDDDDWDDDDDDDFWWDDWDDDDDDDDDDDDFDDD
DDDDDDDFWWDDDDIFDDDDDMFWDDWWWDFGDDDDDFWWDWWWDDDIDDDDDFDDDDDFDDDFWDDDDDDDDDGFDDDDDFWWWWFDDMDDDDDFDDDD
DDDDFDDDDDDDDDDDDDDDDDWWDDDMDIFDDDDDDWWDWWWDDDDDDDDDDDDDWWDWWWDFDFDDDDDDDFDDDDDDDDDDDDDDWDWWDDFWDMDD
DDDDWDDDDDDDDDFDDDDDDDDDDDDDDDDWDDDDFDDDDDDDDDDDDFDDDDDDDWDDDDDDDDDDDDDIDWWDDDDDWWWFDDDDDDDDDIFWWDDD
DDDDWWFDDDDDIDDFDGFDFFWDDDDDDDDDMDDFDDDDDDDDDDDDDDDDDWFDDDDDDDDDDDDDDDDDDDDDDDDDFIFDDDWFDDDMDDDDDDDD
DDDWWDDWDDDDDWWWFDDDWWWDDFDDDDDFDGDDDDDDDDDDDDDWWFDDWWDDDFDDDDFDDDWWWDDDDDDDDDDDDDDDDDDDDDFDFDDDDDDD
DFDDDDDDDFDDDWDDDDDDDDDFDDDDWWDDDFDDDWWFDDDDDDDDDFDDDDDDDWWWDDDDDDDDFDDDDDDDDWFDDDDDDDDDDFDDDDDIDDDD
DDDDDDDDDWDDDDDDWDIDDDDDDDDDDDDFWWFDDDDDDDDDDIDDDDDDDDDDDDDWDDFMDDDDDDDDDDDDDDDDDWDDDDMDDMDWDDDDDDDD
DDDDDDDDFWWWFDDDWDDDDWWDDDDDDDWWDDDWWFDDDDDDDDDFDDDDDDDDDWDWWDDDDFDDDDDDDDDDDDDDDWWWFDDDDDDWWDDDDDDD
DDDDDDIFDDWWWWDDDDWDDDDIDWWDDDDDDDDDDDFDDIDDDDDDDDDDDDDDDWFFWDDDDWWWDDDDDDDDDDFWDDDFDDDDDDFDWDWDFDDD
DWFDDDDDDDWWDDDDDDWWDDFDDWDDDDDDDDDDDDDDDDDDDWWFDDDDDDDDDWWDWWWWDDIDDDDDDDDWWDDWWFDDDDDDMDWWWFDDDDDD
DWWFDFWWDDDDDFDDDDDDDDDDFDDDDDDDDWWDDDDDDDDDDDDDDDDDFDDDDDDDDDDDDDDDDDIFFDDDDDDIDDDGFGFWDDDDDDDDDDDD
DDDDDDDDDDDDDDDDDDDDDDDWDDDDWDMDFWWDDDDDDDDIDFDFMDDWWDDDDDDDDDDDDDDDDDDDWFDDDDDDDDDDDDDWDDDDDDIFDDDD
DDDDDDFDDDDFDDDDWWWDDDDDDDDFDDDDDDDDDDDDDDDDDDFDDDDDWWDDDDDFDDDDDDDDDFDDWWDDDDDDDDDFWDDDDDDDWWFFDDDD
DDDDDDWWWWDWDDDDDIDDGDDDDDDDDDDWDDDFDDDDDMDWWDDDDIDWWDDDDDFDDIFMDDDDDWWDDDDIDDDDDDDFWWWDFWWDDDDDDDDD
DDDDDMDDDDDWDDDDDDDDFDDDDDDWWFDDDDDDDDDDDDDDDFDDDFDDDDDDDDDDDDDDWDDDDDDDDDDDDMMDDDDDMDDDDWWDDDDIDDDD
DDDDDDDWDDFDDDDDDDDFWWDDWWDDDDDDMIDDDDDDDDWDDDDDDDDDDGDDDDDDDIDDDDDDDDDWDDDDDDDDDDDDDDDDDDDDMDDDDFGD
DDDFDFDDDIFDDDDWWDDDDDDDDDWDDFDDDIDDDDDDDDWWDDDDDDDDDDDDDDDDDDDDDDDDDDDDDDDDFMDDDDDDWDDDDDFDDDDDDDDD
DWWWDDDDDDFDWDDDDWDDDDDDDDDDDDDDDDDDDDDDFDDDDDFGFDDIDDFDDDDDDDFWDDMDDFDDDDDDDDDDDDDDWWFDDDWWFDDDDDDD
DDIDDDDDWWWDDDDDDIDDDFDDDDDDFDDIFDFDDDDDWDDDDWWDDDDDDDDDFDDWDWWWWFDDDDDDDDDDDDDFWDDDDDDDDDDDDDDDDDDD
DDDWWDDFDDDDDDDDDFWWFDDDDDDFWWWDDDWDDWDFDDDFWFDDDDWDDDDFDDDDFDDDDDDDDDDDIDDDDDDWDDDDWWDDDWFDFDDDDDDD
DDDDDDDDDDDDDDDDDWWWWDDDDDDFDDDDFWWDWWDDDWDDWWDDDFWDDDFWDDDDDDDDIDFDDDDDDDIDDDDDDDWFDDDMFWDDDDDFDDDD
DDDIDDDDDGDDDIFDDDDWWDFWWFWWFDDDGFDDDDDDDWDWDDDDDFDDDDWWDDDDDDDDDDDDDDDDDDFDDDDDDDWWWWDDFDDWDDDDDIFD
DDDDDDDWDDDDDDDDDFDIFWDDDDDDDFWDDDDDDDDDWWWWWFDDWDDDDWWDDDFDDDDDDDDGDDDDDMDDDDDDDDDDDDDDDDDDDDDDDDDD
DDDDDDWWDDDDDDDFDDDGDWWWDWWDDDDDDDDDDDDDDDDDDDDDDDDDDDDDDDWFDDDDDDDDDDDDDDDFDDDDDDDDDDDDDDGDDDDDDGDD
DDDDDDDDDDDDDDDDDDDDDDDDDDDDDDDDDDDDDDDDDDDDDDDDDDDDDDDDDDDDDDDDDDDDDDDDDDDDDDDDDDDDDDDDDDDDDDDDDDDD