;Map made by Santella Agustin
;element index
;  D : Diert
;  M : Mountain
;  W : Water

; starting the level:
DDDDDDDDDDDDDDDDDDDDDDDDDDDDDDDDDDDDDDDDDDDDDDDDDDDDDDDDDDDDDDDDDDDDDDDDDDDDDDDDDDDDDDDDDDDDDDDDDDDD
DDWFDDWWDDDDDWWDDDDDDDDGDDMDDFGDDDDDDDDDDDDDDDDDWDDDDDDFDDIDDWWDDDDDDDDDDDDDDDDDDIDDDDWWDDWDDDDDDDDD
DWWDFDDDDDFDDIDDDWWDWDDDFDDWDDDDDDDDDWDDWWDDDDDDWWWDDDDDFDDDDDIDDDDDFGDDWWDDDDDDDDFIDWWDDFDDDDDDDDWD
DDIDDFDWWDDDDDDWDDDWWDDDDDDDDDDDWWWFWDDFWDDWDIDMFWWDDDDDDDFDDDDDDDDDDDDDDDDDDDDDDDDDDDDDDDDDDDDDDWWD
DDDDDDDDIDDFDDDDDDWDFWWWFDGDDDDDDMDDDDDDDDWWWDDFDDDDDDDDMDDDDWWWFDDDWWDGDDDDDDDFDWDDDDFDWWWWFWFDDWDD
DDDDDFDDDDFDDDDDDDDWFWDDFDDDDDDDDDDDDDDDDFDDDDWWDDDDIDDDDDDDWWDDGDDDFDFDDDDDDDDDDDFFDDDDDWFDDWDDWWDD
DDWDDDIDDDDDDDDDDDDDDWDFDDDDDDDDDDDDDDDFDWDWWDDFFDDWDDDDDFWDGDDDDDDDFFDIFDDDDDDDDFDDDDDWWDDDFWWFDIFD
DDDDDDDDDDDDDWWDWDWFFWWFDDDFWWDDDDDDDDDWFDDDFWDWWDDDDDDDDDDDFDFDDGFDWWDDFWDDDDDDDDDWWDDDFDDDDDDDDDDD
DDDDDDWDDDIFDDDDDDWDDWWWFDDDDDDDDDDDDDDWWDFDDWDDDDDDFDDDDDDDDDDDDDDDDDWDDDDDDDDDDDDDDFDFDDDDDDDIDDDD
DDDDFWWDDDDWWDDDDDWFDDDDDDDDDDDDDDDDWWDDWWWFFWDDDDDFWDDDFDDDDDDDDDWDDWWFDDDDDDWDDDDMDDDDDDDDDDDDDDDD
DDDDDDDDDDDDDDDDDFDDFDDDDDDDDDWDWWWDDWDDGFDMDDDDDDDDMDGDDDDDFFDDDWWWFDDFDDDDDDDDMDDDDDMDDWWDDDDDDDDD
DWWWDDFDDDDWFDDDDDDWWWDDDDGDDWWDDFDDFWWWDDDDMDDDDDDIDDDDDDDDWWDDDDFDDDDWWWDDFDDDDDDDWDDDDDFDWWDDFDDD
DDDDWWWDWDDDDWDDDWFDDDDDDDFDDDDDDDDFWDIDDDDDDDDDDGDFDDIDDDFDDDDDDDIDDDDWWDDWWWFDDMDDDDDDDDWWDDDDWDWD
DDDDDDDDWFDFDDDGFDDFDDDDDWWDDDGDDDFDWWDDDWWDDDDDDDDDDDDDDDWWDDDDDDDDDDDDDDDDDDWWDDDDDMFDDDDDDFDDWFWD
DDDDDWFDDDDDDDDDDDDDDDFWWFFDDDDWWDWDDDFFWWDDDDDDWDDGDDDDDWWDDDDDDFWFDMMFDDDDDDDDDDDDDDDDDDDDDDFFDDDD
DDDDDIDDDDDFDDDDDDIDDDWWFWWWDDDDDDWDDFDDDDDDWFDFWDDDDDDDDDDDFIDDMFDFDDDDDIDMMDDDDDDDFDDDDDDIFDDDDDDD
DDDDDDMDDIDDDDDDDDDDDDDDDDDWWDDDDWWDDDFDDDDWWDDWWWDDDDDFDDDDDDDDDDDDDIDDDDDFMDDWFDDWWDDDDDDDFGDFDDDD
DDDDDDDFDDIDDDDDDDWWDDDDDDDDDDFWDDDWWFDDDDIDDDDDDWDDDDWWWDDDWDDDDDDFDFDDDDDDDDDWDDFDFDDDDDDWWDWWDDDD
DDDDDDDDDDDDDDDDDDFWWFWWWWDWFDDDFFDDDDFDDFFFDDWDWDGDDDDDDDDWWWDDGFFWWDDDDWWDDDFDDFWDDDDDDDDDWDDDDDDD
DDDDDFDIDDDDDDWFFDDDDDDDWWWWWWFDWWFDDDDDWWWWFDDDDWFDDMDDDDFDDWWDDWWFDDWDDDDDDDDDDDWDDDDDDDDWDDFDFDDD
DDDDDDDDFWFDDWWDDDDDDWDDDDDDDDWWDWWDDDDDDDDDDDDDDWWDDIDFDDWDDDDDDDDWWWWWDDDDDDDDFWFWDWWDDDGDDDDDDDDD
DDDDDDDDDDDDFWDDDDDDDWFDDDDDDDDDGFDDDDDDDDDDDDDWWDWDDDDDDWWDDDDDMDDDDDDDDDDDDDDDFDWWDDDGDDDDDDDDDDDD
DDDFDDDDDDDDFWWDDDDDWFDDDDGDDDDDDDDDDDDDDDDDDDFDFWWFWDDDDFDDFDWWDDDDDDDDDDDIDDDDWWDDFDDDMDDDDDWWDIFD
DDDDDFDDDDDDDDDDDDDDWWWDDDDDDDDDDDDDDWDDFFDDDFDDDDDDWDDDFDDDDDFDWWDDDDDDDDDDDDDDGDIDDDDDDDDDDDDFDDDD
DDDDDDDDWFWWDDDDDDDFDDDDDDDDDFDDDFWWFDDWWWWDDDDDDDDDWDDFIDDDDDWWDDWDDWDDDDDDDDDDDFDWDMDWDDDDDFDWDDDD
DDDDDDDDWWDDDMDDFFWWDDDDDDDDDDDDDDDDWDFDWWDDDDFDDWWDDDDDDIDFDDWWWDDDDDDDDDDDDIDDFDDMDDDDDDDIDWFWDDDD
DWWDDDDDDDDDDDDDDDWFDDWDDDWWDDDDDDDDWWWDDIDDDDWWDDDDDDDDDDWWDDDDDDDWDDDDDDDDDDDDDDDDDDDFDWWDFWWWDFGD
DDDDDDDDIDFWDDDDDDWDDDWWFDWDDDDDIFDDDDIDDDDFDDDDDDDDDDDDDDFDDFDDWFWWDDFDDDDDDDDDGDDDDDDWWDDDDDDDDWDD
DWWFDDDDDDWDDDWFDDWWWFDIDDDDFGDDFDFDDDDDDDFDDDDDDDDDDWDDDDWWFWWDWDDDDDDDDDDDDDDDDDDDDDDDDDDWWDWDDDDD
DDWDDDWWWWDDDDDDFDDDDDDDDDDDDDDWWDDDDIDDDFDDFWFDDDWWFWFGDDWWWFDFDDDWDDDDDFDDDDFDDDDDDDDDDDDDDDWDDDFD
DWWWDWWDDDDDDDDDWWWFDIFDDDDDDDDWWFDDDFFDDDDFWWWDDDDDDWWDDDDDDDDDFDDDDDDDDDDDDDDDGFDWDDDIDDDDDFDDDFDD
DDDDDWWWWDDFDDGFDDDDDDDDMDDFDDDDDDDWFWWDDDFDDDDWDGFDDDDDDIFDDFDDDDDDIDDDDDDDDDDWDDWWFDFDDDDWWDDDDDDD
DDDDDDDDDDFWDDDDDDDDIDDDDDDDMDWWDDFDFDDDDDWDDDDWWDDFWWWDDDDDDWFDDWWWDDDDDGDDDFWWDGDDDDWWWFDDDDDFDDFD
DDGDDDDDDDDWDWWFDIDDDDDDDFDDDDFDDDDDDDDWDFDDDDDDDDDWWDFDIDDDDDMDDDDDDDDDDDDWDFWDDDDDDDDDDDDDDDDFFDDD
DDDWDDMDFWWDDDDDDDDMDMDMDDDGFDMDFWDDDDWWDDGFDDDDDFDFFDDDIDWDDDDDDDFWDDDMFDDDDWDDDWDDWFDDDDDDFDFWWDDD
DDDWFDDDDDWWDDDDDDDIDGDDDDDDFWDDDDDDDDDDIFDDDDDDDDFWWWDDDDDDDDDDDDDWDDDDWWFDDWWDDDDDWDDDGDDWWDFDDDDD
DFWWWDDDDDFDDDDDDDDDDDDDDDDDDDDDDDFDDDDDDDDDWDDDDDDDDDGFDDDDDDDDDDDDDDDDFDDDDDDDDDDDDDDIDDDDDDDDWFDD
DDDWWFWWFFDDDDDMDDDDDDIFDDDDDDDDFDDDDFDDDDDDWWFDDDFDDDDDDDDDWDDDDWWDDDDDDFDDDFWWDDDDDDDDDWWWDDFWWDWD
DDDDFDWWDDDFDDDDDFDDDDGDDDDDDDWDWDDDFWWDDWDDDDDDDDDDDDDDWDDWWDDDDGDDFDFDDDFWFDDDFDWWDDDDMDDDDDDDFDFD
DDMDWDDDDDDWWDDWDDFDDDIDWFDDDDDDDDDDDDWWDDDDDDDDDDDDDDDWWWWFDMDDDDDDDDDDDGFDDDDDWWDDDIDDDDDDDDFDDDDD
DDDDDDWWWDFDMDWWDDWFDDDDDDDDDDDDDDWWWWWDDDDDDWDDDDDIDDDDDDWWDDDFWDDDDDDDDDWDDDDDDDFWDIFDDDDDDWWWFDDD
DDFGDDDDDDDDDDFWWDDDDDWDDDDDDDDDDDDDWWDDMDDFWWWWFWWFDDDDDWWFDDDDDDDDDDDDDDWWDDDDFDDDDDDDDDDDDDDDDDDD
DDDDDDDMDDDFWDDDDWDWDDWWDDDDDDDDDWDDDDMDDDFDDDDDDDFDDDDDDDDDDDWWFFDDDDFDDDDDWWFFDDDFMDWDDDDDDDDDWFDD
DDDDDDDDDDDDDDDDDWWFWWDDDDDDDDDDWWDDDDDGDDDDDDDDDDDDDDFDDDWDDDDDDDDDDDDDDDDDFWDDDDDDDDDDDDFDDDDDWFWD
DDDDDDFDDDDDDDDDDFWWWDFWWDDDDWFDDFDDDDDDWFDDWWWDDWWDIDWFDWWFIDDDDDDDDDWWDDDWWWDDDDDDDIDDDDDDDDDDWDDD
DDDDWDDDDDWDDDDDDDDDDDDDDDDDDWWWDDFDDDDDWDDDDIFWWDDDDDDDDDDDDDDDDDFDWDDDDIDDDDDDDDDDDDDDWWDDDDDWDDDD
DDWDWDDDDDDDDDDWWDDDWWDIDDDDDDFMDDDFWWWWWWDDDDDDIDWDFDDDDFDIDDDDWWWDWWDWDDDDDFDDDFFWWDDDDWDDMDDWWDDD
DWWWWDDDDDFDDDDDDDDDDDDDDDDDDWWDDDFDDDFIDDDDDDFIFWFFWWFWWFDDFWWDFDDWDDDWWFDDWWDDDWDDFDMDDDIDDDDDDDFD
DDFDDDDDDDDGFFDDDDDWWDDDDDDDDDWWWDDDDDDDDDDDDWWFDDGDDDDDDDDDDDDDWFDDDDWWDDDDFMDDFWWWWWDDDDDDDDDDWDWD
DDDDDDDDDDDDFDDDGDDWDDDDFWWFDDFWWWDDFWDDDGDDDDDDDDDIDDDDDDFDDDDDDDDDDDDDFDDDDDFDDDDDDDDDDDDDDDDFDDWD
DDMDDDDDDDDDDFDDDDWWDDDFDDFMDDDDDDDDWWDMFDDDDDDDDWWDFWWWDDDDDDDDDFDDDDDFDDWWWFWFDDDDDDDFDDIDFDDDDDDD
DDDDDDDDFFDDFWWDDWDDWDDDDDDDDFDDDDDDDDDDDDDDDDDDDFDGFWDDDDDDDDDDDDDDDWFDDDFWDDDDDDDWDDDDDDDDDDWWWFDD
DDDWWWFDWWDDGDDDDWWDWFDDDDDDDWWDDFDDDDDDDDDDDDDDDDDDWDDDMDIDWWDDDDDDDDDDDDDWWDDDDIDWWDWFDDDDDDFDDDDD
DDDDDDDDDDDDFDDDDDDFWDWDDDDDDDDDDDDDWWDDDDDDDDDMDDDDWWDDDDMDDDDDDDWWDDDDDDDDDDDDDDDDDDDDDDDWFFDDDDDD
DDDDDDDDDDDFDDFDDDDDDDDDDDDDDDDDFDDDDDDDDDDWFDDDDDDDDDDFDDDDDDDDDWWFDDDDDDDDDDDDWFDDDWFDDDDDDDDDDIFD
DIDDDDDGFDDIDWWWWDDDDDDDDDDFDDDDDDMDDDDDDDFDDDDDDDWWDDDMDDDDDDIDDFDDGDDDDDDDDFDDWWDDDWWDFDDDDDDDDDDD
DDDDDDDDDDDDDDDDWWDWDDDDDDDDDDDDMDDDDDDDDDDDDDDWWWDDWWDDFDDDDDDDFDDDDDDDDDDDDDMDDDDDDDDDDDDDDDDWWDDD
DDDDFWDMDDIDDDDWFDFDDDDWWDGDDDDDDDDDDDWFDDFDDDDDWWDGDDDDDDDWDDDDDDGDDDDDDDDDDDDDDFDDDDFDDWWFDWWFWWDD
DDDDDDDDWFDDDDDDDDDDDDDDFDDDDDDDDDGDDDWDDWWDDWFDDDDDDDDDDDDWWWDDDDDDDDDDDDDDDDDDDDDDDFWWDDDDDDDDFIDD
DDDDDDDDDDDDDDDDDDDWFWDDDFDDDFDDDDDDDWWDDFIDFWWDDDDDDDDDDDDDDFFDWWDDDDDDDDDDDDDDDDDWFDFDFWWDDDDFDDDD
DDDDDDDDDDDDDDMDDDFWWWDDDDFDDDDDDDDDWWFDDDDDDDDDDDDDFWWDDDDDDWWWDDDDDDDDDDDDDDDIDDDDDWWDDDDDDDDWWDDD
DDDDDDDWDDDWWFDDDDDDDFGFDGDDFDDMDDDDDDDDDIDDDIDDDDDDDDDDDDDWWDDDFDDDDFDDDDDFWWDDDDDDDDDDDDDIFDDDFDDD
DDDDDDDDDDDIFFDDDDDDDDIFDDDDWWDDDDWDDDDFDDDDDDGDDDDDDDDIDDDDDDDWWWDDWWDDDFDDWDFDDWDDDDDFDGDDFDWDDDDD
DDDDDDDDFDDFDDDDWWDDDDDWDDDFWWWDDWWWDWDDDDDDDDDDDDIDDDDDDDDDDDDDDDFDDDDDDDDDDDWWFWWFDFDDDDDFDDWDDDWD
DDDDDMFDDDDDDFDWDFDDDDFDDDDDWWDDDDDDDWWFDFDDDDDDDWDDWWWDDDDDDDDDDDWDDDFDDDDDDDDDWDDDDDDDDDDDDFDDMFDD
DDDDDDWWDFWDDDFWWDDDDDDDWDWDDDDDDDDDDDDDWWDDDDWDDDFDDDDDDDDDDDDDDFWWDDDDDDFDDDDWDDDGDDDDDGDDIDDDDDDD
DDDDDDDDDFDDDFDDDIDDIDDDIDWWWFDDDDDIDDDWWDWDDDDDWDWFDDFWWDDDDDDDDDDDDDDDDDDDDDDDDDDDDDIDDDDGDDDDDFWD
DDFWWFDWWWDDDDDFWDDDDIDDDDDDDDWFDDDDDDDIDDWWDWDDDDWWWDDWDDFDFDDDDFDDDDDDDDDWWDDDDDDFDDDFDDDDDDDDDDDD
DDDWWDDDWDDDDDDDDDWWWDDDDDFDDDDDDDDDDDDDWWDWDWWDDDDDDDDDDDWWDDDDDWWFDDDDDDDDDDDDDDDDIDFWWWWDDDDDDDDD
DDDDDDDFWWDDDDDDDDDDDDDDDDDDFDDDDFDDDDWWFWDWWWWDDDFDDWWDWDDDDDDDDDWWDDDDDDDDDWDDDDDDDWDDDDDWWDDDDDDD
DDDDDDDFDDDDDFDFIDDDFWWDDWWDDFDDDDDDWWDDDWWDDGDDDDWDDDDDDDDDDDDDFDDFWWDDDDDDDDDDDDWFDDDDWWWDDDDFWWDD
DDDDDDDDDDDDDWWDMDDWDDWWDDDDDWWWDIDDDDIDDDDIDDIDFWWFDDDWDDDDDDDDDDDDDDDDDDDDIDDWDDWDDFDDDDDDFDWDDDDD
DDDDDDDDDDDDDDDDDDDWWDDDDDDDDDDDDDFWWWDDDDDDDDDDDDDDDDDWWDDDFDDDDDDDFDDDDDDDDDFWWWWDDDFDDDDDDDWDDDDD
DWFDDDDDDMDDDDDDDMDDDDFDDDDWFFDDFDDFDDWDDDDIDDFWWDDDDDDDDWWWWWDDDDFGDDDDWDDFDDGDDDDDDWWDDDDDDFDDDDDD
DDDDDDDDDDDDDDDDDDDDFDDDDDDWWWWDDDDWDDWWDDDDDDWWDWDDDFDWFFDDDDWDDDDDDDDDWWFDDDFDDDIDDDDFWDDDMDDDDDDD
DDDDDDWWDDDDDDDDDDDDFDWWWDDWWDDDDDFDDDDDDDMDDDDDDDDDWWDDFWWWDDWWDDFDDDDDDDWDDDWDDDDDWDDDGDDDDFDDDDGD
DDDDDWWWFDDDFDDDDFDWWDDMGDDDDDDDDFDDDDWFWDDDDDDDDDDDDFDDDDDDDDDDDDDDDDFFDDWDDFWWWDDDWWFDDMDDDDDDDDDD
DDDDFWDDDDDDFDDDDDDDDDDDDFWWDDDDDFDDDDDFWWDDDDDDDWWDDDFDDDDDDDDDDDDDDWWWFDWWDDDFDDDDDDDDIFDDDDDDWFDD
DDDDDDDDWFDDDDDDDDGDDDDWWDWWWDDDFWWWDDDGDDDDDDDDDDDDDDDDDDDDDDDDDDDDFDDDDWWDDDDDDDMDWDDDDMDDDWWWWDFD
DDDDDDDDDDDDDDDDDDDDDDDDDDDDDDDDDDDDDDDDDDDDDDDDDDDDDDDDDDDDDDDDDDDDDDDDDDDDDDDDDDDDDDDDDDDDDDDDDDDD