;Map made by Santella Agustin
;element index
;  D : Diert
;  M : Mountain
;  W : Water

; starting the level:
DDDDDDDDDDDDDDDDDDDDDDDDDDDDDDDDDDDDDDDDDDDDDDDDDDDDDDDDDDDDDDDDDDDDDDDDDDDDDDDDDDDDDDDDDDDDDDDDDDDD
DDDDDDDDDDDDDDWWWFDFWWWFDDDDDDDDDDDFWDWDWWDDDDDDDFIDDDDFDDDWDWFDDDDDDDDDDDDDDDDDDWDDDDDDDDFDDDDDDDFD
DDDDDDDDDDWWDDDDDDFIDDMDWWDDDDDWWDDDDDDDWWWWWDDDDWDWWDDWDDWDWWDDDDDDDDDDFDDDDDDDDDDDDDDDDFDDDDDDDDDD
DDDDIDDFDDDFDDWDWFDDDDDDDDDDDFDFDDDDDDDDDMDDFWWDWWFDDDDDDDFDDDDDDDWWWDDWWWDWDDDDDFDDDDDDDDDDDFDDDDDD
DDDDDDWWDDDDFWWDDDFMDDDDDDFDWWDDDWFDDDDWWFWDDDDDDDFWDDDDDDDDDDDDDFWWDWWDWWFDDDDDDDDDDDDWDDDDDDDDDFWD
DDFWDMDDDDDDWDDDDDDDDDDFWWWDDDDDDDDIFDFWWDIDDDDWWDFWDDDDDDDDDDDDFDDDDDDDFDDDFWDMDDDDDDDWDDDDDDDDDDDD
DDWWWDDDDWDDDDDDDDDDDDDDDDDDDDDDDDDDDDDDDDDDDDDDDDDWDWFDDDDDMDDFDDDDDDDDDDDDDDDDDWWDDDDWWDDDDWFFDDID
DDDDWWDFDWWDDWDDFDWFDDDFFWWFDDFDDDFWWWDWWDDDWDDDDDDWFDDDDDDDDDDDDDDDFDDDDDDDDDDDDDDDFWDDDFDFWWWFDDDD
DDDDDDDDDDDWDDDDDDWDDDWWDDWWWDDDDDDWDWWDDDDDDDDDDDDWDDDWDDDDDFDDDDDDDDDDDDFWWDDDDFDFWWFDDDDDDDDDDDDD
DDDDDDDDDWWWDDDDDDWDDDFWWWWDDDDDDDFDMIDDDDDDDDDDDDFDDDDWWDDDDDDDDDDDDFDDDDDDWWDDFDDWWDDDDDDDDDWWDDDD
DWWWDDDFDDDDFWFDDDWWDDDGDDDDDDDDDDFDDDDFDDWDDDDFDDDDDDDWDDDDDDGDDDDDWWDDDDDDDDDDDDDDFDDFDDDWFDDDDIDD
DDDDDDDDDDDIDMDDDDDDDDDDDDDDDDDDDDWDDDFDDDDDDFDDDDDDFDDDFFIDDDDDDDDDDDMDDDDDDDDDDDDFDDDWWWDWWDDDDDDD
DDDDDDDDFDDDDDDDDDDDWDDDDDDFDDDDDDWWDDDDDDDDFDDDDDDDWFWDWFDDDDDDDDDFDDDDDDDDDWWFDWWWFWDDFDDDDDDDDDWD
DDDDDDDDDDDDGDWDDDDDDDDIFWWDDDDDDMDDDDDDDDDFDDDDDDDWWDDDWDDDDWDDDDDDDDDDDDDDDDDDDDDDDDDDWWDDDDDDWWDD
DDWFIFWDDDDFDDDFWDDDDDIDDDDDDDFDDDDWDDGFDDDDDDDDWWDDDDDDDDDDDDDDDDDDDDDDDDDDDFDDDDDDDDDWFDDDDDDDDDDD
DFIDDDDDDDDDDDDDDDDDDDDDIDWWWFIDDIDDFDDDDDDDDDDWDDDDIDIFDIDFDDDDDDDDDDDDDFDDDDDGDDDDDDWDDDDDDDDMDIFD
DDDDDDDDIDDDDDDDDDWWFWDDDDDDWWDFDDDDDDDDDFDDDDDDDDWDDDDDDFDDDDDDDDDDFWDDDDDDDDDGFDWWDDDDDDDWWDDDDDFD
DFDDDDDDDDDDDDDDDDDMFDDDDDDWWDFWDFDDDFDWDDGDDDDDDDWWFDDDDIDDMDDWWDFMDWWDGDDDDDDGDDDFWFDDDFWWDDDDDDDD
DWWDDDFWWDWDDGDDDDDDDDDDIDDDDDDDDWDDWWDWWDDDDDDDDDDDDFDWWDDDDDWDWWWDDDDDDDDDDDDFGDFWWFDDDDDDIFDDDDDD
DDDDDDDDDDDFDFDDDDDDDDDDDDDDDDDDWWWDFWFDFDDFDDFDDDDDFDDMDDDDWWWDWWDDWDDDWWDDDDDDDDDDDDDDDDDDDDDDDDDD
DDDWWDDDDDDDDWDIDDWWFDDDDDDDDDDDDFIDDWWDDDWWDDDDDDDDDDDDDDDDDDDDDDDDWWDDDDDDDDDDDDDDFWWDDDFDDDFWDDWD
DDDDDDDDDDDDDDIDDDDDDDDDDDDDDDDDDWDDDDDWWWDWWDDDDDDDDWWDFDDDWWDDDDFDDDDDDDIDDDDDFDDDDDMDDDWWDFWWDDDD
DIDDDDDDDDDDWDDDDWFDDFWDDDDDDDDDDDDFDDDDDDDDWWDDDDDDDFDDDDWDDDDDDDDDDDIDDDDDDDDDDDDDDDDDDDWWWFDDDDDD
DDDWWDDDDWWDWWDFWWDDDWWWWDDDDDDDWDWDDDFDDIDDDDDDDDDDDWFDDDDDDWWDDDDDDDDDDDDDDDDDDDDDDDMDFWWFDDDIFDDD
DWWDDDDDDDDDDDDDDDDDDDDDDDFFWWFFDDDGDDDDDDDDDDDDDDDFWDDDDIDDDDDDDDDDDDDDWWWDDDDDDDDDDDDDDDDDMDIDDFDD
DDWFDDDDDDDDWDFDDDDDDFWWFDDDDDDFDDDDDDFDDDDDWDDDDDDDDWDDDDDGDDDDDDDFDDFDFWWDDDGDWDWFDDDDDDDIFFDDDDDD
DDWWFDDDDDWDDDWDDDDDDDDWWDFGDDDWFDDDDDDDDDDDDDDWDDDDWFDDDDDDDDDWDDDDDFDDDDDDDDDDWDDIDDDDDDDDDDDDWDFD
DDFDDDDDDDWWDDDDDWWWDDDDDDDDFDFDDDDDDDDDDFDFDDDWWDWDDDDDFWWWDDDDDDDDDDDDDDWWWDDWDDDDDWDWDDFDDDDDDDWD
DFWFDDDDFDDDDDDFWFDWWFDDDFDWWDDDDFGFDFDDFIDWWDDDDWWFFDDDDDDDDDDDDDDDDDDDDDDDDDFWWDDDFWDDDDDDFDDGDDDD
DDWWDDDDDDDDDDDDMDDDWWDWDDDDDWDDDDDDDIDDDDDDWDDDDDDDDDDWDFDFWDIDDDDDDDDDDDDDDDDWDDDDFDDFDDDDWWDFIDFD
DWWDDDFWWFFDDDDDDDWWWDDWWDDDDDDDDDWDDFWWDDDDWWWWWDWDDFDWDDDDDDDDFDDDDDDDDDWWFDDDDWFDDDDDDWWDDDDDDIDD
DDDDDDDDDDWFDDDDDDDDWWDFFWDDIDDDDFDDDDDDDDDDDDDDWDWDDDDWWDWDDDWWDDDDDDDDDDDDDDFDDDDDDDWFDDDDDDDDDDWD
DDDDDWWWDDWDDDDFDDDDDDDWWWWFDFWDDDMDGFDDFDFDFDDDDDIDDDDDFDDDDDDDWDDDDWDDDDDWWDDDDFDDDFDDDDDDDDDDDDWD
DWWWDDDDDDDDFDDDDWWDDDDDWFGDDFWWDDDDDDDDDDDDDDWWDDDDFDWWWFDDDDFWWWWDFDDDDDDDDDDDDDDDDDDDDDDDDWWWDDDD
DDDDDDDDFDDDDDDDDDDDDDGDDGFDDDDDDFDDDDDDDDDMFDDDDDDDWDDDDDDDDWDDDDDDDFDDDDDDDDDDWDWDDWWFDDDDFDDDDDDD
DDDDDDDFDDFDDDDWWWDDDDDWDFDDIDDDDWDDIDDDDDDDDDDDDDDDDDDDIDFDDDDDWDDDDDDMDDDDDDDDWWWDFGDDFFDDWWDDDDDD
DDDDWDDDDDDDFGDDDDDDDDDDDWWDDDDDDWDDDDDDDDDDDDDDFDFDFDDDDFDFDDDFDFDDDDIDDDDDDDDDDDFDDDDDWDDDDDDDDDDD
DFDDDDDDFWDWDDDDDDDDDDDFDDDWDDDDDWDDDDDFDDDDDDDDDDDDDDDDFDDWDDDWDDDDDDDDDDWWWDIFDFDDDFIDWWWDFDDDDDDD
DDDDDDFWWWFWWFDDDDDDDDDWWDFDDDDFFWWDDWWWDIDDDDDDDDDGDDFIFDDDDDDWDWDDDDDFDGDDFDDDDDDFDDFDDDFDWFMDDDDD
DDDDDDDDDDDDIDDFDDFDDDDIFDDDDDDWWWDDDDWDDDDWWFWDDDDDDDDDDDDDDDWWDWDDDDDWDDDFWFWWWWDDDFDDDDWDWFDDDDDD
DDDDDDDDDMDDDFWWWDWDDDDDDWDDDDDDDDDDDWWDMDDDDDWDIDDDDFDDDDDDDDDDDWWDDDFWWDFDDDDDDDDWWFDDDWWFDDDFDDDD
DDDDDDDDDDDDDDDDDWWDDDDDDWWDGDDDDDDDDDIFDDDDFDWWDDDDDDDDDDFIDDDDDDDMDDDFDWWDDDDDDDDDDDDDDDDDFFDDDDID
DDDDWWDWWWWWDDFMDDDDDDDDFDDDDDDDDDWDWWDWDDIFWWWDWWDDDDDWWFDFDDFDDDDDDIDMDDDDDDDDDMDDDDDFDDFDWWDDDDDD
DDDDDDDDWFDDDWWDDDDDDFDDDDDDDDDDDDDDDDDDDFDDDDDFDDDDDDDDIDDDDDIDDDDDDDDDFDGDDDWDDDDDDWDWWWWDDGDFDDDD
DDDDFDDDWWDDFWFDDWWDDDDDDWDDDDDDDDDDDDIDDDDDDDDDDDDDDDDDFDDDDDDDDDDDDFDDWWDDDDDDDDDDFDDWDFDDWFDWWDDD
DDDDDDDDDDDFWWFDDDDDDDDDDWWDDWWDDDWWWWDDDDFDDDDDFFWDIFDDDDDDDDDDDFWWWWDDDDDDDWDDDDDDDGDDDDDDDDDDMDDD
DDDDDDFDDDDDDDDDDDDMDDDDFWWDDDDDDDWDDWWDDDMDDWWWWDDDDDDDDDDDDFDDWWWFFWWFDMDDFWWDDDDDDFDDDFWWDDDDDDDD
DDDDDFIDDDDDDDDDDDFDIDDDIDDDDIDDDDDDGDDDWWDDDDDDDWDWDDDWFDDDDWWDDWDDDDFDDDIFDDFDDDDFDDDDDDDDDDDDDDDD
DWWDWDDDDDDFDDDDDDWWFDDDDGDDDIDDDDDDDFDDDDFWWDDDDWWWWDDWDDDDDFWDWWDDDDDDDDDDWWDGDDFDDDDDDWWDDDDDDIDD
DDDWWDDFDDDDDDDDDDDDDDDDDDDDDDDDDDWDDDDDDDDDDDDDDDDDWDDWWDDDDDDDDDDDDDFDDDDDDDMDDDWWDDDDDDDDDDDFDDDD
DDDDDDDWDDDDDDDDDDFDDDFDDDDDDDDDDWWDDDDFWWDDDDDDDDDDDDDWDGDDDDDDDDIDDDDGDFDDDIDDDFDDDDDDDDDDDDDWDDDD
DDDDDDFDDDFDDDDWWWWWDWWWDDFDDFDDDDDGDWDIDDDFDDDDDDDDDDDWDDDDDDDDDDDDDWDDDDFDDFWWDDDDDDDDDFDDDDDWDDDD
DDDDDDDDDDDDWWDDIFDWFDDDDDDDWWFFDDDDFWWDDWWWDDMDDDDDDFWDDDDDDDDFDDIDDWDDDDDDDWWDDDDDDDDDDDDDDDDDFDDD
DWDDDDDIDDDDDDDDDDWFGDDDDDDDDDFDDDDDDDDDDDDDDFFWWDDDDWFDDWDDFWWWDDDDDWWDDDDDWWFDDDFWDDDDGDDDDDDFWWDD
DDDFDMDDDDWWFDDDDDWWFDFDDDDDDDDDDDDDDWWDDDDDDDDDDDDDDDDDDDFDGDDFWDDDWDDDWDWDDDDMDDDDDFDFDDDDDFDDDDWD
DDDWWDDDDDDDWDDDDDDDWWWDDDDFDDWDFIDDWFDDDDDDDDWDDDDWDDDWWDWWDDDDIFDDDWFWWFWDDDDDWWDDWWDDDDDIDDDDDDDD
DDDDDDDDIDWDDFDDDFDDIDDDDDDDDWDDDFDDDDDDDDMDDFIDDDWWWDDDWWDDDFDDDDDFWWDDDDWWDDDDDDDDDDDDDDDDFDWWWDDD
DDGDWWFDDDDDDIDDDDDDDDDDDDDDWDWWDDDDDDDWDDDDFDDDDDDDDDDDDDDDWWDWWWDDDDFWWDDDDDDDDFDDDFWWDFWWWDDWFDDD
DDDDDDDDDGDWWDDDDDMDDDDDDDDDDWWDDFDDDDDDDDWDDDDDDDDDDDDDDDDDDMDDDDDDWWFDDDDDDDDDDDDMDDDDDMDDDDDIDDDD
DDDDIDWWWDDFDDDGFDDIDDDDDFDDDDFDDWDDDDDDDWWDDDDDDDDDDDDDDDDWFDDWDDDFDDDDDDDDDDDDDDDDDFMDDDDDDDDDDFWD
DDDDDDDDDDDDDDDDDDDDDDGDDDDDWDDDDDDDDDDDDDDWWWDDDDMDDDDDDDWDWDDWFDDWWFDDDDDDDFWFDDDFFDDDDDDDDWWDWWDD
DDDDDDDFDDWWDDFWWWDDDDDDDDWDDDWWDDDDDFIFDDDDDFDDDDDDDDFWWWDWWDDWDFDDDDDDDDDDDFDDDDWWWDDDGDDDDWFFDDDD
DDDDDFWWDFDDDDDDMDDFDDDDWFDDDGDDDDDDDDDDDDDDWWDDDDDDDDDDDIDDDDDWDWDDWWDDDDDDDDDDDFDIFDDDDDDDDWWWDDDD
DIDDDIDDWWDDDDMDDFDWDDDFWFDFDDDDIDDDDDDDDFWWDDDDDDDDDDDDDDWWFDWWDMDDDDDDDIDDMDDDWWFDDDDWWDDDIDDDDDDD
DDDDDDWWDDWFDDDFWWFWWWFFDDWWDFDDDDDFDDDGFDIFDDDDDDFDDDDDMDDDDDDDDDDDDDDDDDDDDDFDWWFDDDIDDDWWFDIDDDGD
DWWDIDWDDDDDDDDDFWDMDDDDDDDDDDDDDDDDDDDDFDDDDWDDFFWDDDFDDDDDDWWDDDDWWDDDDDDDDDWDFWWFDDDDDDDDDDDDFWFD
DDDDDWDWWFDDWDWDDWWDDDDDDDDDDDDDDDDWWWDWWFDDDDDDWDDDDDDDDDDDDWDDDDDDDDDDDDDDDFWWDDDDWWWDDDDDDDWDDWWD
DDDDGFWDDDDDDDWDDDDDDDDDDDDDDDDDDDDDWWFMDDDWWFWDWDFDDDIDDDDDDDDWWDDDDDDDDDDDDDDDWWWDDDDDDDDDDDWWWDDD
DDDDDDDDDDDDDDWWWDDDIDDFWFDDDFMDDDDDDDIFIDDDDDDDDDDDDDDDDDDDDDDDWWDDDDDDDDWWFWDDWDDDDDMDDDDDWWDDDDDD
DDDDDDDDDDDDIDDDDDDDDDDDDDFDWWDDWDIDFDDDDDFDDDDFDDDDDDDDDDDDDDDDDDDDDDDDIFDFFDDFDDDFDDDDDWDWDDDDDDDD
DWDDFDDDDDDDDDDDDFDDDDDFDDDDDDDDWWDWWDDDDDWWDDWWDDDDDDDDWDDFDDDDDDDFDDDIDDWWDDDFFDDWWDDDFGDWDFDFDDDD
DWWDWWFDDFDDDDFDDDFDDDFDDDDDDDMDDDWFDDDDWWWWWDDDDDDDDDDWWWWWDFDDWWDDDDDDDDDDDDDWFDDDDDDDDFWWDDDDFDWD
DDDDDDDDDDDDDDWWDDWWWDIDDDDDDWDDDFDDDFDDFWDFDFIDDDDDDDDDFDDDDDDDDDDDDDDDDDDDDDWWDDDDDWDDDDDGFDDDWWDD
DDDDDDDDDFWWWWWWFDDGDDGDDDMDDDDDDDDDWWDDDWWWDDDDDWWWDDDDIFDDWDDDDDMFWFDDDDDWWDDDFDDDWDWWFDDIDDDMDDDD
DFDDDDDDDWWWFDDIDDDDWWDDDDDFDDDDDDDWDFWWDIDDDFWWDDDDWWWDDDDDDFDDDDDWWDDFWWDDDDDDDDFDDWWWDDDDDDDDDDDD
DDDDDDDDDDDDWDDDWWWWDDDDDDWDDDDDDDDWWWDWDDDDDWDFDDDDGFDGDDWFDDDDDDDDIDWWWWDWWDWWDWWDDDDDDDDWDDDDDDWD
DDDDDDDDDFDDWWFDDWWDDDDWDDWDDWDFDDDDDDDWDDMDDWWWDDDDIDDDFWWWFDDIDDDDDDDDDFDDDDDDDDDMFWWDDDDMDDDDDDWD
DDDDFDDDDIFWWDDWWDDDDDDWDWWDDMDDDIDDDFFDDDDDDDDDFDDDDIDFDDDDDDIDDDDDDDDDDDFDDDDDDWDDDDDDDDFDFDDDDDDD
DDDDDDWWDDDDDWWDDDDDWWWWDDDDIDDDDFDDFWWDDDDDDDWFDDDFDDFWWDDDDFDFDDDDDDDFDDDDDDWWDWDDDDDDDFWWFFDDIFDD
DDDDDDDDDDDDDDDDDDDDDDDDDDDDDDDDDDDDDDDDDDDDDDDDDDDDDDDDDDDDDDDDDDDDDDDDDDDDDDDDDDDDDDDDDDDDDDDDDDDD