;Map made by Santella Agustin
;element index
;  D : Diert
;  M : Mountain
;  W : Water

; starting the level:
DDDDDDDDDDDDDDDDDDDDDDDDDDDDDDDDDDDDDDDDDDDDDDDDDDDDDDDDDDDDDDDDDDDDDDDDDDDDDDDDDDDDDDDDDDDDDDDDDDDD
DDDDDDDDIDDDDFDDDDDDDDDDDDDDDDDDDDDDDDDDDDDWDDWDDDFDDDDDDDDWDDDDDDFMDDDWDDIDDDDFDDDDDDDDFWDDDDDFDDDD
DDDDDDDDDFWWDDDDDDDDDDDDDDDDDDDDDDDDDDDDDDDWDWWDDDDDFWWWWDDDDDFDDDDDDDFWFDDDDDDDDDDDDDDDDWWDDDDWWWDD
DDDDDDDDDDDFWWDDDDFDFDDDWWDDDWWFFDDDDDDDDFWWDDDDDDDDWDWDDDDDDDDDDDDDDDDWDDDDDDDDDWWDDDDDDDDDFDDDDDDD
DWWWDDDDDDWWDDDFDFDDDDDDDDWWFDDDIDDDDDWDDDDDDDDDDDDDDWDFDDDDFDDDDDDDDFDWDWWDMDDDFDDIDFDDDDDDDDDDDGDD
DDDDDIDDDDDDFWWWWWDFMFDDDFWWDDWDDDDDDDWWDDDWWDDDDDDDDDWWFDDDDDDMDDDDDDDWFDFDDDDDDDDDDDDDDDDDDDDDDDDD
DDDDDDDDWDWDDDDWWDDDDDDDDDDMDDWWDFIDDDDDDDDIDDDDDDDDDDFDDDIDDDFFDDDDDDDWWDDDDDDDDWDDGFDDWDDFDDGFDDDD
DDDDDDDWDDWDDDDDDDIDFWWDDDDDDDWDDWDDDDDDDDDDDDDDDDDDDDDDDGDWDDWWDDDDDDIDDDIDDDDDDWWWDWWDDDDDDDDDWWDD
DDDDDDDDWWDDFDDDDDDDDDDIDDDDDFDDWWDDDMDDDDDFDDDDDDDDDWWDDDDDDDDDDDDWWFDDIDDDDDWDFDWDGDDDDDDDDDWDDDDD
DWWDDDDFDDDDDDWWDDDDDDDDDFDDDDDDWWWWDDDDDDWWDDDDDDDDDDWWFWWFDDDDFDDDDDDDDDDDDWWDDDDDDDDFDWFDDWWWDDDD
DFDDDDDDFDDDFWFDDDWWDDWDDDFDDDDDDDDDDDDDDWWDDMDDDDGDWDFWWDFDDDDDDDDDDDDDDDDDDDDDDDDDDDFDDDDDWWDDDDDD
DDDDDDWWFDGDDDDDDFDDDDWFWDWWDDDDMFDDDDWWDDDDMDDDDDDDIFDDWWDDDDFDDDFDDDDDDDDDFDDGFDDDDDDDDDWWFDDFWDDD
DIDDDIDWWWDDDDDWFWDDWWWFWWWWDDDDDDDDDDDDDWWDDDDDDDFDDDDDDWFIDFDDDDDDDDDDDDDDDDDDDDDDDWDDDDDFDDMDWFDD
DDDWDDDDDDDDDWDWWFDDDDDDDIDWWDDDDDDDFDDDDMDWDWWDDFWDDDDFFDDFWWWDMFDWDDDDDDWWDWDDDDDDDWWDMDFDDDDDDIDD
DDFIDDDDDDWDDDDDDDDDDDDDDGDIDDDFDWWFDDDDDDDWWDDDDDDDDDDWDDDDWDDMDDFDDDDDDWWDDDDDDFIDDDDDDDDFWDDDDDDD
DWFFDFWDDDWDDDFWDDDDDDDDDDDDDDDWWDDDDDDDFWDDDFDDDFDDDDDDDDDDDDDDDFWDDDDDDDDWWDDFWDDDDMDDWFDDWWDDMDDD
DWWDDWWDDDDFWWFDDDDDDDDDMDMFDDDDDDDDDWWDWWWDDWWDDDDDIDDDDDDDDIDDWDDDDDDDDDDDDDMDDFDDDDDDIFDWDDDDDDWD
DDDDDDDDFDDDDDDDDDFDDWDDDDFDDDDDDDDDDDDIDDDDDIDDDDFDDDDFDDDDDDDDWFDDFWDDFWDDDDDDDDDWFWFIDDDDDDWDDDWD
DDDDDDDFWWFDDDDDDDDFWWDFIDDDDFDWWWFDDDDFDDWWFFFDDWWWDDDIDDDWDDDDDDFDDWFFWWDDIDFDWFDDDDDDDWDDDDWWDDWD
DWDDDDDDDWWFFDDFDDDIDDDDDDFWFWWDDWWWWDFDDDDFWWWFDDDFDDDDDDDWWDFDDDDDDWDMDDDDDWWDWWDDWFDDWWFIDDDDDFWD
DDDDDDMDDDDDWDWWDWDDDDDIDFWWDDDFDWWDDDWWDDFDWWDDDDDDDDFDDWDDDDDDFWDDWWFDWWDDDDDWWDDDDDDDDDDDDDDDDDWD
DDIDDDDDDDDDDDDDFDDDDDDDDDDDDDDWDDDDDDDDDDWWFDGFDDDDDDDDDDDDDFWWWWDDDDDWFDDDDDFWDDDDDDDDDDDWDDDDDDWD
DGDDDDDDDDDMMDFDDDDDDDDDDDWWDDWWDDDDDDFWWDDDDDDWWWDDWDDDGDDDDDDWDDDDWWDWWDDDDDDWWFDDDDDDDDFWFWWFDDFD
DFDDDDDDDDDDDDDDDDDDDMDDDFDDDDIDFDDDDDDDDDDDDDDDDDDDWDDDDDDDDDFFDDDDDDDFDGDFDDDWDDDDDWDDFDDWWDDDDFWD
DWWDFWWWDFFDFDFDDDDDDDDWWWWWWDDFWFDDDFDDDDDFDDDFDDDDDDDDDDDFDDWWFDDDDFDDDFWWFDDWWDDDDDDFWWFDDDDDDDDD
DDDDDDDDDWWDDDWWFDDDDDDDDDDDDDDDDDDDDGFDFDDDDDFDDDDDDDDDDIDWWWDDDWWDDDDDDWWWDDFDDIDDDDDDDDDDDDFDDDDD
DDDDDDIFDDDIDDDDFDDDDDDDDDDDDDDDDDDDDDDWWDDDDFDFDWDDFDDFDDWDDIDDIDDDDDWWWFDDDIDDDDDDDDDDDDDDDDDIDFDD
DDDDDDDDFDDDWWWDDDDDDDDWWDDDDDDIDDDWWWDDWWWDFMFWDWDDWDDDDDWDDDDDDWWDDGDWDDDDDDWWWFDDDMDDWWDDDGDDDGDD
DDDDDDFWWDDDDDWDDFDDDDWWDDDWDWWDDWWDDDDDWWWDDDFWWWDWDDFDDWWDFMDDDDDDDDDDDDDDDDDDGDDDDDDFDWWFDDFDIDDD
DDDDWWDDDDDDDDDDDWWDDWWDDDDDDDDDDDDDWWWWWWWDDWWDWDDWWDWWDFWWDDDDDDDDFDDDFDDDDDDDDWWDDDDWWWDFWWWDDDDD
DDDDFFDDDIDDDDDDDDDDDDDWDDDDDDDDDDDDDWDDWWFDDDDDDDDDDDDDWWDDDDDDDDDDWDDFDFDDDDDDDDDDDDDDDDDFDDFDDFDD
DDDFWWDMDDDMDDDDDDDDDDFDDDDDDDDDFDDMDDDDDFWWFDDDDDDDDFDDDDDDDDDDDDWWWDDFDDDDDDDWWDDDDDDWDDDWDDWWDDDD
DFDDDDDIDDDMFMDDDDWDDDWFDDDDDDDDWFDDDDDFDDDDDDDDDDDDWDFDDFDWWDDDDDDDDWWWDDDDWWWWDDDDDDDDDDDDDDDIDDDD
DMDFDDDDDDDDDDDDDDGDDDDDDDFIDDWDDDDDDDDDDDDWWWDDDDDFWDDDDDDDDDDDDDDDDDGDDDDDDDDDDFWDDDDDWDWDDDDDDWDD
DDWWDWWWDDDDDFDDDDDDDDDDDWWDDDDDGFDDDDDDDDDWWDDDDDDDWWWWDDDDDDDFDFDDDDDFWWFDDDDDDWWWDDDDWDDDDDDMDDDD
DDDDDDDDDDDDDDDDDDDDDFDDDWWDDDDWDDMDDDDDDMDDFDDDDDDDDDDDDDDDDDDDDDDDDDDFGDDDDDDDDWDDDDDFWWDDDDDDDDDD
DDDDDWWDDFWWDDDFDDDDFDDDDDDWDWDDDDDDDFDFDDDDWWDDDDDDFDDDDFWWFDDDDDDFDDDDDDDDDDDDWWWDDDDDWWFDMDDDDDWD
DDDDDDDDDDDDWDDDDDDDWWDDDDDDDWDDWDDDFWWFDDDGFDDFDDDDMDDDDDDDDDDDWWWWFDDDDFDDDDDDDDDWFDIFDDDDDWWDWDDD
DDFWDDDDDDIDWWDDDDDDDFDDFWDDDDDFWFIDDDDDDDDFDDDWDWDDDDDWDDDDFDDFDDDDDDDDDDDDFDDDDDWDDDDDMDGDFWWDDDDD
DDWWFDDDWDDDDDDDDDDDDDDFDDDDDDWDDDDDDDFWDDFDDGDWWWDFFFWWWWDDDDDDDDDDDDDDIDWWWDDDDDDWWDDFDDDDDDDDDDMD
DDDDDDDDWWDDDDDDDDDDDDDWDDDDGDWWDDDDDDDWWFDDDDDDDDFWWDDDDWDDDDDWWFDDDFDDGDWWDDDDDDWDDDDDDFDDDDDDMDDD
DDWDDDDWDDDDDDDDDDWFDFWWDDDDDDFWDDWDDDDDDDDDDFDDDDDDDDDFDDFIFDDDDDDDWWDDDDDDDDDDDDFDDDFDDDDDIFDDDDDD
DDWWDDDDDDDDDDDDDDWWDDDFWDDDDDWWDDDFWWWWDDDDDDDDDDDDDDWWDDDDDDDDDDDDFDDDDDWWFIDDDWFDDDWWDFWDDDDDDDDD
DDDDDDDDDDDDDDDDFDDDDDFWWFDDDDDDMDDDDDDDDDDDFDDWDDDWDDDDDDGDDDWDDDDDDDDDDDDWDDDDWDDDDDFWWDDIDDDDDDDD
DDDDDDDDDDDDIDGFDDDDDWFDDDIDDDDWDFWWWWDDDDGFDMDDDDFWFDDDIDDDDDWFDFDDDDDDDDDWWWDDDIDDDDDDDDFDDDDDDDDD
DWDDWWDDDDDDDDDDDDDFWWFDDDDFDDDWDFWDDDDDDDFDDFDDWDDWDWWWDDFDDDDDWWDDDDWDDDDDDDDDWDWWFDDWWDWWDIFFDWWD
DWDDDDDDWWWFDDFDDDGDDDDDDDDWWWDWDDDWWDWWFDDDDDDDDDDWWDDDFFDDDDDDDDDDDDDIDDDDDDDDWWDFDDDFWWWDDDWWDDDD
DWWDDDDDIDFDDDDDGDDWWFDDDDDDDDWWWDFDDDDDDGDDDDDDDDDDFDDDDDDDDWWDDFDDDDDDDDDFWDDWDDWWFDDDDFWDDDDWDDDD
DDDDDFIDDDDIDDDDDDDDIDDDDDDDDDIDDDDDDDDFDDDDDIDDDDDDDDDDDDDDDDDDDDDDWWWDDDDFWWDDDWWDDDDDDDDDDDDWDDDD
DDDDDDDDDGDDDDFWWWDDDDFDDDDDDDDDDDDDDDWWFDDDDDDDDFDDDDDDDDDDDDDDDDIDDDWFDDDMDFWDDDDDDDDDWWDDDDDWDDDD
DDDDDWDFDDMFDFDDDDDDDDDDFDDDDDDDDDDDDDWDDDDDDDDDDDDDWDDDDDFDWWDDDDDWWDDDDDWDDDDDDDDWDDDDDDDWWWDDDDWD
DDDDWDDDFDDWWWDDDDDWDIFWWDDDMDDDDDDDDWWDDDDDDDFWWFDFDDDDDDDDDDDDDDDDDDDDDDWWFDDWDDFWDIFDDWWDDDMDDDDD
DDDDDDDDDDDWFDDDDFWWDDDDFDDDDDDDDDDDDDMDDDDDDDDDDWDFDDWDDDDDDDDDDDDDDDDDDWFFDDWWDDDWDDDDDWWDDDDDDDDD
DDDDDDDIFDWWDDDDDFWDDFDDWFFDDDFWDDDFDDDDDIDDDDGFWWDDDDWDWDDDDDWFDDDDDDDDFWWDDDDDDDDWWWDIDFDDWWDDDIDD
DDDWDDDDDDFWWWDDFWWDDWDDWFDDDDDMIDDWWDDDDDDDDDDWDFDDDDDDDDDDDDWDDDDDDDDWDDDFDDDDDDDDFDDDWWDDDDDDDDDD
DDWWFDFDDFDDWDDDDDDDDWDDDDDDDDDDFDDWWDDWWDIDDDDWWWDDFDDDGDDGDWWDDDDDDDDDDDWWFDDDDDDFDDIDDDDDDDDDDDGD
DWWDDFWFDDDWDMDDDFDFDDDDDWFDDDDFWWWWDWDDDDDDDDDDDDDWWDDDDDDDDMDWWDDDDDDDDWDDDDWFDMDDDDDDDGDDDDDDDDDD
DDDDWDDDDDFWWDFDDDDDDFDDDDDDDDDDDDDDDWWDDDDFWDFWDDFDDDDDDDDDDDDDDDDDDWFDFWDDDDDDDDDDDFDDDFDDDDDDDDDD
DDWWWDFDDDDWWDDDDDDDDWDDDDDDDDDDDDDIDDDDDDDWWDDDDDDDDDDFDDDDDDDDDDDDWWFDDWWDMDDWFDDDDDDDDDDFFDDDDDDD
DDDDFWWFDDDDDWDDDDFDDWDDDWDDDMDGDDDDDDDDDDDDDDDDDDDDDDWWDDDIDWWDDFDDDDWDDDGFDDWFDIDDDDDDDDDWDDDMDWDD
DDDDDDDDDFDDDDFIDFWWDWWFDWWDDDDDDMDDDFWDDDDDDDDMDDDDDWWDDIDDDWWDWWFWWWWDDWDDDDDDDDWDDFIDDDFDDDDDDWDD
DWWDDDDDDDDIDFDDIDDFDDWFWDDDDDWWFDDDDDDIFDGDDDDDDDWDDDWDDFDDDDDDWDDDDDDDFDDDDDDDDDDDDWDDWWDDDFWDDDDD
DDDWWWDDFDDDGDDDMDDDDDDFWFMDDDDDFDDDDDDFDDDDDDDDDDDDDDWWWDDWWDDDWDDDDDDWWFDDDDWDFWDDDDDDDDDDDDWDWDDD
DDDDDFDDWDFDDDDDDDDDDDDDDDDDDDIDDDFFDDFMDFDDDDDDWWDDDDFDDDDDDDDFDDFDDDDFDIDDFWWFDWDDDDDDDDFIDWWDMDDD
DDGDDDDDDFWWFDDDDGDDDFDGDWFFDDDDDDWWWDDDFWDDDDWWDWDDWDWFDDDWDDDWDWWDDDDDDDDDDFDDDDDDDDDDDDDDWDDFDDDD
DDDDMDFDDDDDIDDDDDDDDFDDDDDDDDDDDDDDDDFFDDDDDDDDFWWWWWWWDDDWWFFWDDDDDFDDDDDDDDDDWFDDDDFWDDFWWWDWWDDD
DDDDFDDDDDDDDDDDDWDDFWFDDFDDDDDDDDDDWWWWFFDDDDDDDDDIFDDDDDDFDDDDDDDDDDDDDDDWWDDDWDDWDDDDDDDDDDDDDDDD
DDDWWDDDDDDDDDDDDWWFDDDDDDMDDDDDDDDDWDDDDDDDDDDDDDDDIDDDDDDDDDDDDDDDDMMDDFWWDDDDDDDDDWWDDDDDDDDDDIDD
DDDDMDDDDDDDDDDFDDWWFDDDDDDDDDDDFFWDWDDDDDDDDDDIDFDDDWWWDFDDDDDFDDDDDDFDDWDDWDDGDDDFDDDDFDDDDDDDDFDD
DDWWDDDDDDDDDDDDDFDDDDDFWFDFDDDDWWWDWWDDDMDDDDDDDDDDDDDFDDDWWDWWDDWWWWWDDDDDWWDDDIDDDDWDDDDDDDDFDDDD
DWFDDDIDDDDDDDWDFMDDDDDDDDDWFDDDWDDDDDMDDDDDFDFDDDDDDDDWWDDDFDDDWFDDWDDDDFDWWDFDDDDDDDDDDDDDDDWWDWWD
DDDFWDFDDDDDWWWDDDDDDDDDDDFDDDDDWWWFDDDDDDFDWWDDDDFDDWFDDDDDGDWFWWDDWWDWWWFWDDDDDDDDDDDIDDFDDDFDFFDD
DDDFDDDDDDDDWFDDDDDDDDDDDWDDDDWDDDDDDDDDDDDDDDDDDDWWDDDDDDDDFDDDDDDDDDDDDWWWWDDDDDDMDDDDDFFDDDDDWWDD
DFDDDDDWDDDDWFFDDDDDDDDDFWWDDFWDDDFDDDDMDDDDDDDDDDDWWDDDDDDDDDDDDMDDDDDDDDFDDWWWFDDFDFDDDWWWDDDDFDDD
DDFWDDWWWWDDIDDDWDFDDFWWWWDFFWWDIFWDDFDDDDDFDDDDDDGDDDFWDDDDDFDFDDDIDDDDDDDDDDDDFIDWWWWWDDMDDDDFDDDD
DDDDDDDDDDDDDDDDIDWDDFDDDDDDIDIDDDDIDDDDDWDDFDDDDGDDDDDDDDFDFDDDDDDFDDDDDDDWFDWWWFDDDDWWDDDDDDWFDDID
DDDDDDDDDWWFDDWWDWFDDWDDDDDIFDDDDDDDDDDDDDDDDDDDDDWWDDDDDDDDDDDDDFWWDDDIDDFDFWWFDGDDDDDGFDWWDWWDDDMD
DDDDDFDDFDDFWWFWDDDDDDDDDDFDDDDDDDDDWDDFIDFDDDDIDDWDDDDDDDDDDDDDMDDDDWDIDDDDWDDFWDIDDDDDIFDDDDDGFDDD
DDDFWWFDDDDDDDFWFDDDDDDDDDDDFDFDDDDDWDDDDDDDDWFDDFWDDDDWWDDWDDDDDDDDDDDDDDDDWDDWWDDWWDFFDWWDDDDDDDDD
DDDDDDDDDDDDDDDDDDDDDDDDDDDDDDDDDDDDDDDDDDDDDDDDDDDDDDDDDDDDDDDDDDDDDDDDDDDDDDDDDDDDDDDDDDDDDDDDDDDD