;Map made by Santella Agustin
;element index
;  D : Diert
;  M : Mountain
;  W : Water

; starting the level:
DDDDDDDDDDDDDDDDDDDDDDDDDDDDDDDDDDDDDDDDDDDDDDDDDDDDDDDDDDDDDDDDDDDDDDDDDDDDDDDDDDDDDDDDDDDDDDDDDDDD
DDDDDDDDWWWDDDDDFDMDDFDDDWWFDFDDDDDFDWDDDWDDDDDDDDDDDDDDDDDWWDDWWDWWDFGDDDDDDDDDDDWDDDDDDDDFIDFDDDDD
DDDDDDFWDDDDDDDFDDDDDDDDDDFWDWDDDDFWWWDDWFDDDDDDFWFWDDDDDDDDDDDDDDDDDDFDDDDDDDDWDWWDDDDDWDDWDWWDDDDD
DDDDDDFWWFDDDMFDDWWFDDDDDDFIDWWDDDDDDDDFDDFWDDDDDDDDDDDWWDDDFDDDDDIDDWWWWDDIFDDWWDDDDDFWWDDDDDDDDDDD
DDDDDFDDDDDDDDWWWFDDWWFDDGDFDDWDDDDDDDFDDDDDDDFDDDDDDDDDDFDDWDDWDDDDDDDDDDDFDMDDDDDDDDDDFWDDDDDWWFDD
DDWWDWFWWWFDDDDDDWWDDDDDDIDDDFWWFWWFDDDDWDDDDDDDDDFFDDDDDDDWDGDWWDDWDMDDIDDDDDDDDDDFDIDDDDDWWDDDDDDD
DDDWDDDDDGDWWFDDWWFDWWFDDFDIDDFDDDWDDDDDDFDDDDDDDDWWDDDDDDDWWDDDDDWDDDDDDDWDDDDDWDWWDDDDWDDDDDDDDDDD
DFWWDDDFWDDDWWFDDDDDDMDDFWDDFWFDDDDDWWWDFDFDMDDDDDDDDDDWWDFDDDDDDDDDDDDDDWWDWWWDWWWWDDFWWDFWDDDDDDDD
DDDDDDDDDDDDWDDDWDFDDDDFWWFDDWWDDDDDDIDDDFDDDDDDDDDDDWWDWDWDDIDFDFDDDDDDDDDWDDDDIDDDDDDDDDWWDDDFDDDD
DDDDFWWDDDDDDGFDDFDDDDDFWDDDDDWWDDDDDDDFWWDDDDWDDDFDDDDDWWWDDDDDDDFWDDIDDDDWDDDIDDDWWDDDDDDDDMFDDFDD
DDDDDDDFDFDDDDDDDFDDDDDDWFDDDDDDDIDDDDDDDDDDDDDFDWWDDDDDDDWWDWWDDDDDDDDDDDDDDDDDDFDDWWWFDDDWWDDDDWDD
DDDDDDDDGDDDDWWDDWDDDWDFWDDDDDDDDDDDFDWDDDWDWWFWDDDDDDDIFDDDWWDDDDDDDWWWFDDDDDDDWDDDDGDDDDDIDDDDDWWD
DDDDMDDIDWFDDDDDDWWFWDMDDDDDDDDDDWDFDDWWFDWFWDDDDDDDDDDDDIDWWWDMDDDGDDDDDDDDDWDDDDDDDDDDDDDDDDDDDMDD
DDDDFDDDWWDDDDDDMDDDDDDWDDDDWDMDDDMDDDFDDDDDWWWDDDDDDDWWDDDDDIDDDDDDDWWDDGDDDDDDDDDFDDDDDDDGDDDDDFWD
DFFDDDDDDDWDDDWWDWFDDIDDDDDDWDDDDGDIDDDDDFDDDDDDDDFDFDDDIDDDDDDDWWDDDDDDDDDDDDDDDDWDDDFDDDDDDDDDDDDD
DWWDFDFDDDDDDDFDWWDDGDDDIFWWWDDFDDDDDDDDDDDDDFDDDDDDDDDDFWWDWWDDDFDDDDDFDDDWDDWWDDDDDFWDDDDDDFDFFDDD
DDWWDDDDWWDDDDDDDDDDDDDDDDDDDWDDDDFDMDDDDDDDDDDDDDDDDDDDDDDDDDDDDDDDDDDDDDDGDWFDDDDDDDDDWDDDDDDWWDDD
DDDFWWDDDDDDDDDDDDFDGDDDDDDDDDDDDDDDDDDIDDDDDDDDDIDDDIDDFDDDDDDDDDWDDDDDDIDDWDDDDDWDWWFWFDDDDDDGDFID
DGDIFDDDDDDDDDDDMFWDDDDDDDDDDFDWWDDDDDDDDDDWWDFDDDDDDDDDWWDDFDDDDWDDDFDFDDDDFWFWWDWWWDDDWDDFDDDDDDDD
DDDDDWDDDDDDDDDDFWWWFDDDDDDDDWDDDDDDDDDDDDDDDDWWDDDDDDWDDDDDDDDDDDWDDDDDDDDDWFDFDDDDDDDFWWWWDMDDGDDD
DDDDDDIDDDFWDDDFFDDDFDDDDDWDDDDDDFDDFWWFDDDDFDDDDDDDDWWDWDDDDDDIDDDDDDFDDIDDDDDDDDDIDDDDDWFDDDDDFDDD
DDWWDDDDDDFWWFDWWDFDMDDDDDWWDDDDDWWDDDDDIDDWWDDDDDDDDDDFWDDDDDIDDDDDDDDDDDDDDDDDDDDDDDDWWWWFWDFDWDDD
DDDDDDDDDDDDDDDWWDWDGFDDDFWWDDDIDDDDFDDDDDDFDDDDDDDDDDDDDDWDDDDDDDDDDDDDDDDDDIFDDDDDFDDDDDDWWWWDDDDD
DDDDDFDDWFDDMDDDDDWWDDIFDDDDDDDDDDWDDDDDDDWWDDDDWDDDDDFDDDDDDDWDDIDDDDDDDFDDDDDDDDDDWWFDDGDDDDDDDDDD
DDDDDDDWDDDDIDDDDDDDDDDDDIDDFDFDFWWFDGDDDWWDDWWDDIDDDDWWDWDDDFDDIDFDDDDDDWDDDFDDDWDDWWDDDDDDDDDDDFDD
DDMDDDMDDDDIDDDDDDDDDDWDIDDDDDDDFDDDDDDDFDDWWDDDDDDDDDDDWWWWDDDFDDGDFDDDDDDDDWWDWWDDDDDDWFDDDDDDDMDD
DDDDDIDDDDDDDDDDMDDDDDWWDDDDDDDWWFDDDDFFDDDDDDDDDDDDDDDDDDWDFDWWDDDDWWDWWDDDDDDDDDDDDDDDDDDDDDDDDMDD
DDDDDDDDDGDDDDDDDDWWWDDDDDDDDDWWDDFFWWWDGDDDDDWDDDWWDDDFWDDDDDDFFDDWWWDDDDDDDDDDDDDDDFDDDDDDWFDDDDDD
DDDDDDDDDDWDDDDDDDDDDDFDDFDDDFDDDDDDDDDDDDWWDFDDDDDDDDDDWWDWDWFWWDDDGFDDDDDDDIFDDDDDDDDDDDWDIDWWDDDD
DFIDDDFWWWWDDDWWFDDDFWWWFDDWWWDDDDDDDDDDGDDDDDFDDDDDDWDWDWWWWDDWDDDDDDDDDDDDDDDDFDDDDDDDDDDDDDDDDDDD
DIDDFDDWWDMDDDWDDWDDDDDFWWDDDFDDDDDWDDDDDWFWDDWWDDFDDDDWWWDDWWDDGFDDDDDDDDDDDDDDDDDDDWWFWDDDDDDDDDDD
DDDDIDDDDWDDIDDDWWDDFDDDDDDDDWDDWDDDIDDDDMFDDDDDDDWWWDDDDDWWDWWDDDDDDDDDDFDDDDDDDDDDWDDDDDDDWFDDWDDD
DDDDDFDDDDDFDDDDDDDDWWDDDDDDFDDDWWDDDDDDDDDDDDDDFDDDFFDDWDDFDDDDFDDDDDIDDDDDDDFDDDDDWWWWDDDWWDDDDDDD
DDDDDDFDGDDDDDDWDDDDDDDDDDDDDDDDDDDDDDDFDMDDDDFDWWDDWWDDWWFDDDDWWDDDDDDDDDDIFDWDDDDDDDDDDDDDDDDDDWDD
DDFWDFWWDDDDDDDWWDGDDFDDIDWDDDDDDDDDFDFDDDDDDDDDDDDDWWDDDDIDDWDDIDDDDDDDDDDFWWWFDDDDDDDDDDDDDDDDDDDD
DDWWDDDDDDMDDDDDDDDDDWDDDFDDDFDDFDDDWWWDDDDDDDDDFDDWDDMDDDDDFDDDDDFDDDDDDDDFWDDDDDDDFDFIDDDDDDDFDDDD
DDDFDDDDDDDDDDDDDDDDWDDDDDDDDWWDDDDDDDDDDDDDDDDDDDDDWDDDDDDDFDFDDDDDDDDDDDFWWDDDDDFDDDDDDDDDDFWDDDDD
DDDWWDDFFWWFDDDWDDWWWWWFDDDDDDDDDGDDDDDDDDDDWWWDDDIFWDDDDFDDWWWDDIFDDDIDDDFDDDDDDWWDDDDDFFDDDDWWDDDD
DWWFDDDDDDDDDDDWWDWDDDDDDDDDDDDDDDDDIFDDDDDDDDFDDDDDDDDDWWDWFGDDDDDDDFDDDDGDDDDDDWWWDDDDWWDDDDDWWWDD
DDDDDDDDWDDDDDDDWDMDMDDFWFFDDDDDDDDDDDWWDDDDDDDGDDDDDFDDFWWWFDDIDDDDDDDDDDDDDWWFDWWDDWWWDFDDDDDDDFDD
DDDDDMDDIDDDDDDWWDDDDDDWWDFFDDDDDDDDDWWWDWWDMIDDDWWWDWFDFWFDDDDDDDDDDDDDDDDDDDFDDDDDFDDDDDDDFWWDDWWD
DDDDDDDDDDDDDDDDDDDDDDWFDWWWWDFDFWDDWWDDDDDIDDDDDDDDDDMDDWWDDFWWDDDDDDDDIDIDDFMDDDDDDDDFDDDDDDIDDIDD
DDDDDDDDDDDDDDDDDDDDDFWWDDDDDDDDDWWDDFWWWFWDDDDDDDDDDDDDWWDDDDDDDDDDDDDDDDDDDDDDWDDDDDDDDDDDDMDDDMDD
DWWFDDDDDFDFDDDDFDDDFWDDIDDDDDDDDDDDDDDIDDDFDIDDGDFDDDDDDDDDDIDMDDWWDDDFDDDDDDDDDDDDWDDFIDDDDDDDFDDD
DDDDDDGDDDDWWDDDWWDDDDDDFDDDWDDDDDDDDDDDDDDDDDDDDDWWDDDDGDDDDDDDDDDDWWDDDWDIDDWDDDWWDDDDDDDDDDDDWDDD
DDDDDDDWWWDWDDDDMDDDDDFIDDDFDDDDDDDDDDDDDDDIDDIDDDGDDDDDDDDDFDWDDDDWWFDDDWWDDDWWDWFFDDMDIDDDDDDDDDDD
DDDDMDDDDDDDDDWWDDFDDWWDDDDDDDDDDDDDDDDDDWWDDDDDDDDMDDDFWDDFDFWFDFWDDWWDDDDDIDDDFDMGDDDIFDDDDDFDDDDD
DDDDDDDDDWWDDFDDWDIDDDDDDDDDDDDDFIDDIFDFDDDDWDDFDWFDFDDFWWFFDDDDDDDDDDDDDDMDDDIDDDDDDDDDDWDDDDDDDDDD
DDDDDDDDDWWWDWFWWWDDDDDDDDDDDDDDIDDDDDDWWDDFDDWWDDDDWWDDDDDDDDDFFDDDDIDDDDDDDDDDDDDDFDDDWWFDDDDDDDDD
DDDFFFDWWWWWDDDDDDDDDDGDDDDDDDDDDFDWDDDDDDDDDDDWWDDDIDDDDDDDFDDDDDDDDDIDIDDWFDIDDDMDDDDWDDDDDFDDDDDD
DDDWWWWDDDDDDDDDDDDDDDDDDDDDDDDDDDDMDDDDDFDDDDDDDDDDDDDFDDDDDDDDDDDDDDDDDFFDDDDFDDDDDDDWWDDDFDDDDDDD
DDDDDWDDDDDDDDDIDDDDDDIDFWDDDDDDDDDDDDDDDDDWDDDDDWDDDDFWFDDDDDDDFDDDDFWWDWWDDFDDDDWDFDDDDDIDDDDDDDWD
DDDDFDDDDIDDDDDIDDDDFDDDDDDDDDDDDDIDWWWWDFWWDDDDDDDDDDWWDDDMDDDFWWWWDDGDDDDDDDDDDFDDWDDDDDDDDDDFWWDD
DFDDDFDWWFIDFDDDDDWDDDDDDDDDDDDDDWDFWFDDDWWDDDDDDDDDDDDDDDDDFDFDDDDDDDDDDDDDWDDWDDDWWWDDDDDFDDDGDDDD
DWWDDDDFWDDFWDDDDDDDDDDDDDFWFFWWDDDDWDDDDDDDDDWDDMDDDDDDDDWWDDWFDDDDDDDWDWWFDDDDDDDDDDDWDGDDDWWDDDDD
DDDIDDDWWWDDDDMDDDDFDDDWDDFDDDDDDDDWFWDDWWDDDWWDWDFDDDWDFWDDDFWDDDDDDDWWFDDDDWFDDDDDDDDDDDDFDDDDDDDD
DFDFFFWDIDDDDDFDDDDDDDDDDDDDDDDDDDDDWWWDDDDDDDDDDDWWFWWFDDDDDDDDDDDDIDDFDDDFDWDDDFDDFFDDDDDDDGDDDDDD
DDDWWDFDDDDDDDWFDDDDDDDDFDDDDDDWWDDDIDDWWDDDDDDDDDDFDDDDDWDDDDDDDDDDDDDDDDDDDDDFDDDDWWDDDDDDWDWWWWDD
DDDDFDDFDDDDDDDDDDFWDWWDDDDDDFDDWWWDDDDDDDDDDDDDDDDWDDDDDDDIDDDDDDFDDDDDGDDDDDDIDDDDWWWDDDDDDDDDDDDD
DDDWWDDMDDWWDDDDDDDDDDDDDDDDDDDDWDDDDDDWDDDDDFDWDDDDDDDDDFIFDDDWWDDDDDGDDDDDDDDDDDDDIDDDDIDDDDDDDDDD
DDWWDDDDGFDWDDDDDDDDDDDIDDDDDDFWWDDDDFDWWDDDDDFDDDDDDDDDDDDDWDDDDDDDDDDDDDDDDDDDDDDDDDDDWDDDDDIDDDDD
DDDDDDDWDWDDDDIDDDDDDFDFDDDDDWWDDDDDDWWFDDDDDDWDDDDDDDWWDDDDDDDDDDDDDDDDDDDDDDDDDDDDDDGDWDWWDDDDDDDD
DDDDDDWWFDDDWDDFDDIDDDDDDDDDWFDDWWDDMMFWWWDDWWDDDDWDDFDWWDDDDDWWDDWDMDDFDDMDDDDDDDDIDWDDWWFDDGDDDDWD
DDFDDDDDDDDDDDWWDDDFDFDDDDIDDDWWWDDDDDDDFWWDDDDDFDDDWWWDDDWDDDDDDDDDDFDWWDMDDWWWWWDDDDFDDWWFDDDDDDWD
DDDDWDDDDDFDDDDDDDDDDDDDDDDDFWFWDDDDDDDDDDDDFDDDWDDDDDDDDWWDDMDDDDDDWWWDDDFWDWWWDDDDDMDDDFWWDWWDFDDD
DWWFWDDDFDFIDDIDDDDDDDDDDDDDDWDDFDDDDWWDDDDFDDWWWDDDDDDDDDDDDDDDDDDDIDWWFDDDDDDDDFDDDDDDMDDDDDDDDDWD
DFDFDDDWWDWFDDDDDDDDFWWDDFDDDDDDDDDDDDDDDWDWFDDDDDDDDDDDDDDDDDDDDDIDDMDDDFWDDDDDFWWDDDWDDDDDWWWDDDDD
DWDDDDDDDWWDWWDDDDFWWFDWFDDDDDDGFDDDDDWDWWFDDDDDDMDDDDDDDFDDDDFDDDDDMFDDDWWWWWDDFDDDDDDDFDWDDDDDDMDD
DWWWDFDDDDDDDDDDDDDDFWWWDDDDDFDDWWFDDDDDDDWDDDDDDDDDDDDDDDDGDWDFWWDDDWWDDDDDDDDWWFDDIDIDDDDDDDDFIFDD
DDDDFDFDDDDDDDWDDDFDDDDDDDFWDDDDDDDDDDDDFFDDDDDDIFDFDDMFDDDDWWWDDDDFDDWDIDDDDDDDDDDDDDDDDDDDDDDDDDDD
DDIDDDDDDDDDDDGDDDDDDDDDDDWWDDDDDDDFDDDDWWDDDDDWFDDFDDDDDDDDDDGDDDDDDDDIDWDDWDDGDDDDDWWDDDDDDDDDDDDD
DDDDDDDDWDDDDDDDDDDDDDDDWWDDDDDWWDDDDDDDDFDDDFDMDDWWDDDDDDDDDWFDDDDDDWDDDDDDDDIDDDDDDDDDDDDFWDFDDDFD
DDIDDDDWWWDDDDDDDDDDDDDFDDDDDDWWWDDFWFWWDWFDDWDDDDMGDDDDIDDWDWWDDDDDDWWFDDDDDDDDDDWWDDDFDDDWWFDDDDDD
DDDFDFDWFDDDDDDDDDDDDDWWDDDDDWWFDDDDWDWFDWFWDWWFDMDDDDDDDDDWWDWDFDFWFDDDDFDDFDDDDDDDDDDDDDDDDDDDWWDD
DDDDDWFDWDDDWDDFDDDWWFDFDDDFDDFDDDDDDFDDFDFWFDDDFFDDDDDDDDWDDDDDDDFDDDDDFWDWWWWWDDDWDDWDDDIDDDDFDDDD
DDDDDDDFDDDDWWDDDDDDDDDWWWDDDDWWDWDDDIDDDDDWWDWWWWDIDDDDDDDDDDDDWWDDDDDDDDDDFDDWDDDWDFDDDDDDDDDDDDDD
DWDDDFDDFDDDDDDWDDDDDDDDDDMDDDDDWWWWWDDFDDDDDWWWDDFDDDDDWWDDDDDGDDDDDDDWWDDDFDDWDDDWWDDDIFDDDDDDDDDD
DWDDDWDDDDDDDDDWWDDDDDDDDDDDDFWWDDDDFMFDDDDGDDFDDFWWFDDDFDDFWWFDDDDDDDDDDDFDDDFDDDFDDDDDDDDDFDDDDDDD
DDDWDDDDDDDDDDWDDDDWWDDDDWDDDDDFWDFDDDDDFWDGDWWFDWDDDFWDDDDDDDDDDDWWDDWWDFDDDDDDDDDDFDMDDFIFDDDDMDDD
DDDDDDDDDDDDDDDDDDDDDDDDDDDDDDDDDDDDDDDDDDDDDDDDDDDDDDDDDDDDDDDDDDDDDDDDDDDDDDDDDDDDDDDDDDDDDDDDDDDD