;Map made by Santella Agustin
;element index
;  D : Diert
;  M : Mountain
;  W : Water

; starting the level:
DDDDDDDDDDDDDDDDDDDDDDDDDDDDDDDDDDDDDDDDDDDDDDDDDDDDDDDDDDDDDDDDDDDDDDDDDDDDDDDDDDDDDDDDDDDDDDDDDDDD
DDWWDDDDDDDDDDDDDDDDDDFDDFMDWWDWWDDWWDIDDDDDDDDDDDDDDDDDDDDDDDDMDDDDDFDDFDDDDDDDDDDDDFWWDDDWDDDDDDDD
DDDDDDDDDWDDDDDDDDDDDDWWDDDDWWDFDDDDDDDDDDDDDDDDIFWWFDDFDDDDDDDDWDWDDFDDDDDDDDDDDMDDDDDDWWDDDDDIDDDD
DDDDDDDDWWDDWDDDDDDDDDDFDDDDDDDDDDDDFDDDDDDDDDDDDDDDDDDDDWWDIFDDWWWDDWDDDWDDDDDDDDDDDDDDDDDDDWFDDDFD
DDDDGDDDDDDFDDDDDDDFFDDWWDFDFDDDWWDDWDDFWWDDDDDDDDFWWDDIFDDDDWDGDDDDDWWDDWDWWDDDDDDDDDDFDDDWDDDDDDDD
DDDDDDWWDDDDDDDDDDDWWWDGDDDDDDFDDDDWWDDDDDDDDDDDDDWWDDDDDDDDDDDFMDDDDDDDDDDDDDDDDDDDDDDDDDDWWFDDDDWD
DFDDDDDDWWWDDDDDDIDDDDDDDWDDDDDDDDDDIFDDDDDDDDDWWFWWDDDDDDDDDFDDDDDDDDDWWDDDDDDDDDDWWDDDDFDDDDDDDFDD
DWDDWDDDFDDDDGDDFDDDDDDDDWWWDDDDDDDDDDDDDDDDDDDDDDFDDFDDDDDFWWDDFDDDDWWFDDMDDDIDDDDDWWDDDDDFDDGFDDDD
DWWFWFDDDDDDDDDDDDFWDDDDDDDIDDDFDDDDDDWDDDDDDWWWDWWWDWWDDDDDDWDDDDDDFDDFWWDDDDDDDDDDWFDDDDDGDDDDDDDD
DDDDWWWDMDDDDDDDDDDWFDDDDDDDDDDWFDDWWDWWDWDWDDDWDDDDDDDDDDDDDDFDDWWWFDDDDDDDDWFFDDDDFWWDWDIDDDDDDDDD
DDDDDDFDDDDDDDDDWWDIDFDDDDDDDDDWWDWWFDDDDDDDDDFWFDWWDDDFDDDDFDWDDDDDDDDDWDDDWWDDDDFDDDDDDDGFDDMDDDDD
DDDDDDDDDIFDDDFDDDDDDDDDDDDDFDDFDDMDDDDDDDDDWWDDFDDFIFMDDDDDDDDDDDDWDDDWWWDDFDDDDDDDFWWWDDDIDDDDDDDD
DDDDWWDDDDDDDDDDDDDDDDDDDDDDDDDDDDDDDMDDDDDDDDIDDDDDDDDDWFDMDDDDWWDDDDDDDWWDDDDWDDMDFDDIDDDDDDDDWDDD
DDDDDDDDDDWDDDGDDWFDDMDDDDDDDFWDDDDWWDDDDDDWWWDDDDDDDDDFWDDDIDWWDDDDDDDWFDDDDWWWDDDWWDDFDDFDDDDDDDDD
DDDDDDDDDFWDDDDWWWFWWFDDDDDDWWWDDWDDWDDDDWDDDWWDDDDDDDDDDDDDDDDDDDDDWDDWDDWDDDDDDDFDDDFMDDWFDDDDDDDD
DIDDDDIDDWWDDDDDDDMDDDDDDDWWDWDDDDDDWFDDDDFDDDDDDDDDFWDDDDDDDDDDIDDDWWFDDFDDDIDDFDDDDDDDDWWFDDDDDIDD
DDDDDDDDDDDDDDMDDDDDDDDDDDDDDWDDDDDDWDDWDFWDDDDDDDDDFDMDDFDDDWDDDDFDDDDDDDDIDDDDWWDDDDDFDDDDWWDDWFFD
DDDDDDIFDDDDDIDDFDDDDDDWDDFDDDDDDDDDDDWDDDDDWDDDDDDDDDDDDWWDDDFDDWWDDDDDDDGDDWWDDDDDIDDWWDDDMDDFDFWD
DDDWDDDDDDDFDDWFWDDDDDFDDWWDDDDDDWWDDDFMFDDDDDDGFDFWDIFDDDDDDDDDDDWDFDDIDDDDDDDDDDMFFDDDDWDFDMIDDWWD
DDDDDDDDDDDDDDDDDDDDWWDDDDDDDWWDDDDDDDDIFDDDFDDDDIDWWDDDDDDDDDDDMDDDMDDDDDDDDWDDDDDWWDDDDDFDDIDDDDDD
DDDDDDDDDDDDDDDDDDDDMDDDDDDWWWFFFDDDDDDDDDWFDDFDDDDWDDDDDDDIDDIDDDMDDDDDDDDFWWDDDDFDDWWWDDDDDDDDDDDD
DDDDDFWWDWDWWDDDDDDDDDDDDDDFDDDWWFDDDDDWDWWFDDDDDDDDDDDDDDDIDDDWDDDDDDDFWWDMDDDDDDDDDDDDMDDDFDDFIDDD
DDDDFWWWWWFWDDDDDDDDDDDWDDFWWDWDWWWDWWDWWWWWFGDDWDDDDDFDFDDDDDFDFDDDDDDIFDDIFWDWDDDDDDDDFWWWWFDDDDDD
DDDDDDDDDDDDDDDFWDDDDDWWWDDDDDDDDDWWDDDMDDDGDDDWFDDDDDDFDDDDDDDDDDDDDDDMDFWDDWDDDDDDDDDDDDDFDDDDDWDD
DDDDDDDIDDDWDDDFWWDDWWDDDDDDDDDDDDDDDDFDDDDFWWDDDDDDDDDMDDDDWWDDFWDDDDDDFFWDDDDDDDDDFDDDFDDDDDWWDDDD
DWDFDDDDDDWWDDDDDDWDDDDDIDWDFWDDDDDDDDWDDDDDDDDDDDDDDDDDDDDDDGDDDDDDDDWWWFDDDFDDDDDDDMDDDDFDDDDFDDWD
DWWDDDDFFMDDDDDDDDWFDDWWDDDDDWWDFDDIDDWFFDDDDDDDDGDDDGDDDWDDDFDMDDDIDDDDDDFDDWWDWWDDDDDDDWWDDDWWWDDD
DDDDDDDWWFDDFWWFWWWWDDDDFIDDDFDDDDDDWWWDWFDDDDDDDDDDDDWDDWWWWDDDDGDDDDWWDDDDDDMDDWFDDDDDDDIDDDDDDDDD
DDDDWFDDDDDDDDDDDDDDFDDDDDDDFWDDDDDDDDDDWDDDDDFFWWDDDWWFFIFDDDDDDDDFDDDDDDDWFDDDFWDDFWWDDDDDDDDDWDDD
DDDDDDDDDDDDDDDFDDFWWWFDDDDDDDDDFWWDDDFWWDDGDWWFDDDWDDDDDDDDFDDDDDDDDDDIDDDDDDDDDWWDDDDDDDWFDDDDWWDD
DDDDDDDIDDWWDFDIDWDDWWWDDDDDDMDDDFDDDDFDDDDDWWFWDDWDDDIDWDDDDDDDDFWWDDDDDDDDDWDDDWWWDDDDDDDDDFWWDDDD
DDDDDDDDDFWDWWDDFDDDDIDDFDDDDDDDWWDDDFDDDDDDDDFWFDDDDDFWWDDDDWDDDDDDDDDDDWWDDWWDFDDDDDDDDMDFDIDDDDDD
DDWWDDDDDDWWWDDDDDWDDGDDWWFDDDDWWFFMFWDIFDDDDFDWWDDDDDDDDDDDDDDDDDDDDDDDDDDDDDDDDDDDDDDDDDDDDIFDDDDD
DDDDDDDDDDDDFWWDWWWWDDDWDDIDDDDDDDDDDDDDWFIDDDDDDDIDFIDDDDDDDDDDDDDDDDWDDDDDDFDDDDDDDDDFDDDDDDDDDDDD
DDDDDDDDDDFDDDDWWDDWWWDWDIDDDDDDDDDDDFMDWDDDDDDFDDDDDDDDGDWDDDDDDDDFWDDDDDDGFWWFDDDWWDDDFMDFWWDDFDDD
DDDDDWDDDDWDDDDIFFDDDDDDDDFDDDDDDDDDDDDDWDDDDDWWWWDDDDWDDWWFDWDDMDDDWDDDDDWDDWDDDDDDDDMDWDDFWWWFWWDD
DWFDDDDDWDDDIDDDWWDDDDDDDFIFDDFDDWDDDDWDDDDDDDDFDDFWWDDDDWWFDWDDGDDFDDDDFWWDDDDDDDDDDDFWWWDDDDDDDDWD
DDIFDDWWWWDDDDDDDDDDDDDDDDDDDFWDDDDDDDDDDDWDDDDDDDDWDDDDDDDDFWWWDWWFDFWDDDDWWDDDDWDDDDFDDDDDDDDDDDDD
DDDDWDDDDDDDFWDDWWDWWWDDDWWDDFDDDFDDFDDDDDDDDFDDDIDDDFDDDFWWFWWDDDDDDDDDDFDDDDDIFDDDDWDDDDDFDDDDDDDD
DMDDWDDDDIDDDWFDDDFDDDDDDWWFDMDWWWFWWDIFDDDDWWDDDDDDDWFDDDDDDDDDDDDFDDDWWWDWDDDDDDDDDDDDDDGDDDDDDWDD
DDDDDDDWDIDDDDDWWFWDDDDDDDDDDDDDDDDFDDDDDDGDDDDDDDFDDDDDFDDDDDFDDDDDDDDFWDDWWDDDDDDDDDDWDDDDDDDDDDDD
DDDDDDDWWDDFDDDDDDDDDDDDDDDDDDDDDDDWWFDDDMDDIDDDDDDDIDDDWWDDDDWDDDDDDDDWWWDDIDDDDDDDDDWWDDDDDDIDDDDD
DDWDDDDDDDDFDFDDWWDWWDDDDDDWDDDDDDDDDDDWWDDIDDDDDDFDDDDDDIDDFDDDDDDDDDDDIDDDDDWDWDDDDDDDFDDDDDDDWDDD
DDWDDDDDDDWWDWWDDDDDDWDDDDDWDDDDDDDDFWWDDDDDDWWWDDDFDDIDDDDDWDDFDDDDFDDDDDDDWWWDWWDDDDDDDDDDDFDDDDDD
DDDFDDDDFDIDDDDDDDDDDMDDDDWWDDDDDDDWWDDDDDFDDDDDDDDWDDDDDDFWWDDDFDDWWFFMDDDDDDDDDDDDDDDDDDDDDDFDDDDD
DDDDFDDMDDDDDDDWWDDDDDDIDDDDDDDMDDDDWDDDDDWDDDFDDDWWDDFDDDDDDDDFDDDDDDDDWDDDDDDWWDDDDDDDDDDFMDDDDDDD
DFWDDDDDDGDDDIFWWFDDGFDDFWWDDDDDDFDDWDDDMDDDDFDDDDDDDDDDDDMDDDWWDFDDFDFWWDDDDDDDDWWDDDDDDGFWDDDDDDDD
DWWDDDDDFDFDFDGDDFWDDDWWWWDDDDDDDDDWWDDDDDDDDDDDFDDDDDDDDDDWWDDDWWDDDFDDDDDIDWWDDDDDFDDFDFWWDDDDDFDD
DDMFWWDDWDWWWFDDDDDDDDDWWDDDDDDDDDDDDDDDDDDDDDDWWDDFWWWFDDDDDDDDDDDDDDDDDDDDWWWDDDDDDFDDDDDDDDDDDWDD
DDDDDFWDDDDDDFFDFDDDWWDDDDDDDDDWFDDDDDDDDDDDWWDDDDDDDDDDFDFFDDDDDDDFDDDDDDDDWWWWDDDDDWWFFDDDDDDDDIDD
DDFWWDDDDDDDDWWDDDFDDDDDDDDDDWWWDDDDDDDDDFDDDDDDDDDDDWDDWDWWDWWDDDWWDDFDDDFDDIFDDDDDIFDWWDIDDWDDDDDD
DFDDDDDDMIFDIDFDDDWDDDDFDDIDDDFDIDDFDDDWWWDDWWDDDDFDDWWDDDDFDDDDWWDDIDDDDDWDDDDFDIDDDDDDFDDDDWWDDDDD
DDDMMDDDDGDDDDDDDDWDDDFWDDDDDFDDDMDWDDFDDDFDDDDFWWWDDDDDDDWWDMDWDDDDDDFDDWWDWWDWDDDDDDWWWDDDDDDDDDDD
DDDDDDDDDDDDDDDDDDWWDDWWDDDFDDDDDDWDFWWFDDDDDWWFIDDDIFDDDWDDDDFDWWDWDDDDDDDWDDFWWDDDDGDFWDDDDDIFDDDD
DDDWFDDDDDDDFWWDFDIFDDDDDDDDDDDFDDDWDDDDDDDDDDDDDDDFDDDFDFDDFDDDDDDDDDDIDDFDDDDDDWWDWDDDDDDDDDDDDFDD
DFDDDDDDDDIDDDDDDDDDWDDDDDIFDWDWWDDDDIDDDDDDDDDDDDDDDDDDDDDDWDDFWDDDDDDDFDDDWWDWWDDDWWDDIDDDDDDDFWDD
DDDDFDDWWDDDDDDDDDDFWWDDDDDWDDDDDWWDDDDDDDDDDDDDDDDDDDWWDDDDDFIDDDMDDDDDWWDDDFDDDDDDDDDDDDDWDDDDWWDD
DDDIDDDDDDDDDMDDDDMDDWDDFFWWDDDDDDDDDWDDDDDDDDDDDDDDDDWDDDFDDDDDDDDDDFDDWWWFDDDDDDDDDDWWWWDWWDDFDDDD
DDDDDDDDDDDDDDDWDDDFWWDDWDDDDDFDFDDDDWDDFDDDDDDDDDWWDDDDFDDDDDWDDDDDDDDDDWDDDDDDDDDDDDIDDDDDDDDDIFWD
DDDDDDDWDWWDDWWWDDDDDDDWWDDDDDDDWWDDDDDDWFWDDDDDDDDDDDDDDDDDDFDDDFDDDDDFDWWFDDDDGFDDDWDDDDIDDDDDDWWD
DDDDDDDWWDDDWDDDDDDDDDDWWFWDDDDWWDDDDDDDDFWWWFWWDFDDDDDDMDIDFDDDFDFDDDFDFWWDDFDDIDDDDDDDDDDDDDDFDFDD
DDDDFDDDDDDDDWWDDDDDDMDWWDWWDWWWDFDWWWDDDDDWWDIDWWDDDFDDFDDDDDDDDFDDDDDDDDDWDDDDDDDWWDDDDDDDWDDDDWDD
DDDWWDDDDDDDDMDDDDMDFDDDDDDDDDDDDIDWDDDDDFFDFDDDDDDDFDDFWDDDDDDDDDDDWDDDDDWWWDDDDWFFWWDDDDDDDFDDWDDD
DDFWDDDDDDDDDDDDDDMDDDDDWDDDDDWWWDDDDDDDFWWDWWWDDDDDDDWWWDDDIDFDDDDDDDDDGDDDDDDIDDFDDDDDWWDFDDDDDDDD
DDDGDFWWDDDDFWDDDDFDDDDFDFDWDDDFDWWFDDWDDDDDFDDDDDMDDFWFDDDDDDDDDDDDDDDDDDWDDDDDDDDDDDDDDDWWDDDDFDDD
DDDDDDWDDDDDFIDDWDDDDDDWDDDWDDDDDDDDIDDDDDDDWDDDFDFDFWDDDWWWDDDDWWWFDDDDDDWDDMDDDWDFDDFDDWDFWFDDDDDD
DDDDDDWDDDDDDDFDDDDDDDDDDDDDDDDDDDDDDDDDDDDDDDDDDFWDDFWWWDDDDDDDDDDDDDDDFDDDDFDDWWDWDDIDFDDDDDDFDDGD
DDDDDFWDDDWDWDDDDWDDDDDDDWWDDDWWWDIDDDDDDDDDDDDDDDWDDDDDDDWFDDDWWDIDDDDWWDDDDDDDDDWWDFFDDDDWDDWWDDDD
DDDFDDWFFWWWWDDDWWDFFDDDDMDDDDDDDDDDDDDFFDDDDDWDDWWDDDFWDDWWFDDDDDDDDDDWDDDDWDDDDWWFWWWDDWWWWDDDDDDD
DDDMDWWFDDDDIDFDDDWWWDWWDDDDDDDWFDDDDDDWWDDDDFDDIDDDDDFDDDDDDDWFDDDDDDDDDDDDDDDDDWWFDDFDDDDDDDWDDDDD
DDDFDDDDDDDWDDMDDDDDDDIDDDDDDFFDDFDDDDDDDDDDDDDDDDDIDWWDDDDWDDDDFWDDDDDDDDDDDFDDDDDFDDDDDDDDDWFDDFWD
DDDDDDDDDDDDDDFDDDDDDDDDDDDDFWWDDDDWWFWDDDDDDDDDDDDDMDDDDDDDDDFDDWWDWDDDDWWFDWDDDDDDDDDDDFDDDFDDDDDD
DDDDDDDDDDDIDDDDDMDDDDDDDWDDDDDDDDDDDFDDDDDDDDDWWDDDFDDDDWWFDDDGDFDDDDDDDDDDFWDIDDDDDDDDDDDDDDDDDDDD
DDDDWDDDDDIDDDDDDDDDDDDFWWWDFMDDWWDMDDDDDDDDDWDWDDDDDDDDDIFDDDDDWWDDDDFWWDDFWWDFDDDDDDDIDDDDDDDDDDDD
DDDDWDFDDDDDDDDDDDDDDDDDIDGDDDDMDDDDDDDDDDDDWDWDDDDDDDDDDDDFDDDDDDDFDDDDDDDDMFWFDDWWDGFDDDIDDDDDDWWD
DWWDWDWFWDDDDDMDDDFDDWWFDMDWWWFDDDDDDDFDDDDDDDDDDFDDDDDFDDDDDDDDDDDDDDDDDDDDDWWWDDDDDDDMDDDWFDDDDDDD
DFIDDDDDDDDDDDDDDDDDDDDDDDWDDDDDDDDDDDDDDDDDDDDDWWDDDDDDFDDDDDDDDDDDWDDDDDDDDIDDDDDDDDDDDDDDDDDDDDID
DIFDDDDDDDDDDDDDDDDDDFDDFDDWWFDDDWWDDDFDWWDDDWDDDWWDDDDFDDDDFDDMFWDDDDDDDWDDDDDDDDDWWDDDDDDDDDDMFWDD
DDDDDDDDDDWFWWWDDIDDDDDDDDDDWWFDFIDDDFWFDFDDDDDDDFDDDDDDDDDDDDDDDDDDDDDFDDDFDWWDDDDDDDDDDDDIFDDDFDDD
DDDDDDDDDDDDDDDDDDDDDDDDDDDDDDDDDDDDDDDDDDDDDDDDDDDDDDDDDDDDDDDDDDDDDDDDDDDDDDDDDDDDDDDDDDDDDDDDDDDD