;Map made by Santella Agustin
;element index
;  D : Diert
;  M : Mountain
;  W : Water

; starting the level:
DDDDDDDDDDDDDDDDDDDDDDDDDDDDDDDDDDDDDDDDDDDDDDDDDDDDDDDDDDDDDDDDDDDDDDDDDDDDDDDDDDDDDDDDDDDDDDDDDDDD
DDDGDIDWWDDWWDDMDDDDFDWWDDDDDDDDWWDIDWDDDDWWDDDDDDDDDDDFWWDFDDDGDWWDDDDDDDDDDDDDDDWDDDDFWWDDDDDDWWDD
DWWDDDDDDDDDDDDDDDDWWDDDDDDIFDDDDDDDDDDDDDDDDWFDDDDDDDDDDWDWDDDDDFDDDDDDDDDDGDDDDDDDWWWWDDDDWWFDWDDD
DDDDDDDDDDDDDDDFDDDDDDFDDDDDDDIDDDDDDDDDFDDDWWDDDFDDWDDDFDDWWDDDWFDDDDDDGDDDDDDWDDDDDDDDDFIDDDDFDFDD
DDDDDWDDMDDDDDDIDDDDDWWDDDFDDDDDDDDDFDDDDDWDDDDDDDMDDDDDDDDDFDDDWWFDDDDDDDFMDDFWWWDFDDFDDDDDDDFWFDFD
DDWWFWWDDDDDIDDDDDDDDMDDDDDDDDDDDDFDDDDDDDDDDDDDIDIDDDMDDDWFDDDDDDDDIDDDDDDFWWDDDDWWDDDDDDDDDDDWFDDD
DFWDWWDDDDDDDDDDFDDDDDWWDDDDDDWWDDDFFDDDDDDDDDDDDDDDDDFWDDDDFWWDDDDFFWDDDDDDDFDDDWFWDWDDDDDWDDDWWDDD
DWWDDDDDDWWDDDDWWDFDDDDDDDDWWWWDDGDWWDDDDDWWDWDDDDDDDDDIDDDDDDDDDDDWWWDDDDDDFDFDDWDWDDFDMDDWDDDDFDDD
DDDDFWWFDDDDDDDWWDDDFDDDDDDFDDDDIDDDWDDDWWWWDDDDFWFDDDDDDDFDDDDDDDDDWDDDDDDDDDDFDDFDDDDDDDDWDDWDWFDD
DDDFDDFWDDDDDDWDDFDDWWDDDIDDDDDDDDDDDDWDDFDDDGDDFWWDDDDDDDDDDDDWWFWWWDFDDFWDDDDWWDDDDDDDDDDDDWDDDDDD
DDWWDDWWDDDDDDWWWWWDDDDIDDDIDDDDDDMDDDWWDDMDDDWWFDFDDDDFDDDDDDDDDDMDDDWFFFDDDDWDDDFDDDDDDDDDDDWWFDDD
DDDWWDDDDDDDDDDDDDWDDDDDDDDDDDFIDDDDDDDDDDDDDDDWWFDDFDDDDDDDDDWDDDDDDWWFDFDDDFWDDWWDDFDDDDDDDDDDDDDD
DDDDDFDDDDDDFDDDDDDDDDDDDDDDDDGDDDDDDDDDFWWFDDWWWDDWWDDDDDDFGDDDDDDDDDDDDDGFDDDDDDDDFWWFDDWWDFWDDDDD
DDWFDDDDDDDWWDDDDDIDDDDWWDFWDDDDDDDWDDDDDDDDDDDFDDFWFDDDDDWWDGDDDDDDFWDDDFDIDDIDDFDDDDDDDDDDFDDDDDWD
DDWDDDFDFDDDDDDDGDDDDDFFDDDDDDDDDFDDDDDDDDDDDDWWDDFIDDDDDDDDDFDDDDDDDWWWDDDDDFDDDDDFDFDDDDDWWFDDDDFD
DFWDDDDDGFDDDDDDDIDDDDDDDDDDDDDDDWDDDDFDDDDDDDDDDDDDDFWWDDDDDWDMDDDDDFMDDDMDDDDDDGDDFDDDIDDDIFDDDDDD
DWWDWDFDDDDDDDDDDDDFDDDWWDDFDDDDWDIDDDDDDDDDDDDDDDFWWDDDDDDDDWWDDDFDDDDDDDDDWDDWWDDDFDDDDDDDDDDDDDGD
DDDDDDWWWDFGDDDDDDDDDDFDWFDDDDDDDDFFWFDDDDDDFDDDDDDWFDDDDDDDDFWDDWWDDDDDFDDDWFDDDDFWWFDIDDDDDDDDDDDD
DDDDDDWWFFDDDDIFDDDDDDWWWDDDDDMDDDDFWWWFDDDDDDFWWDWWDFDDDDDDDDDDDDDFDWWFDDWDDDDDDDDDFGDDWDDDDWDDDDWD
DDDDDDFDFWDDFDGDDDDDDDWDDDDDDFDDDDDFDDDWWWDDFDFDDDDWDDDDWWFDDDDDDIDWDDDDWWWDDDMDDFWFDDFDDDGDWWWDDWWD
DDDWDDIDFWWFDDDFDDDDDDDDFDDDDWDDFWFDDDFDDDDDDDDDDDDDIDDWDDDDFGDDDDDDDDDDFDDWWDDDDFWWDDDDDDDDDDWWWDFD
DFWWDDDDDDIDDDDDDIFWWDIDWWDDFWWDDDDDDDDDDDDDDDDDDWWFDDWWDDDDDDDDDDDDDDDDDDDWWDDDDDDDDGDIDDDDMDDFDDWD
DFDDWWDDDDDDDDDDDDDDDDDDDDDDDDDFDDDDFWDDDDDDDDDDDDDDDDDDFWDDFDDWWDDDWDDWWFFWDDDDDDDDDDGDFMDDDDDWDFWD
DDDDDDDFDDDDDDDDWWDDDIDDDDDDDDDDDDFDFDDDDDWDDWDDWWWDDDDDWWWDDDDDDDDWWFWWDDDIDDDDWWWFDDDDWDWWDDDWDDDD
DDDGDDDDDDDDDDDFDWWFDDWDDDDDDDDDDFDFDDDDDWWWDDDDDDDDDDDDDDFWDDDDDDDFDDDDDDDDDDDDDWFDDDFWWFDDDDWWFDDD
DDDDDFDDFDDDDWDWWWDDDFDDDDIDDDDDDDDDDMDDDDDDDDDDDDDDDFDDDDWFWWDDWWDDDDDDIFDDDDDDDMDDDDDMDDDWWWWDFDDD
DDDDDDDDDDDDDWWDDDDDWDDDDDDDDDDDDDDDIFDDWDDMDFDDFWDDFWWDDDDDDFDDDWWDDDDDDDDDDFDDDDDDDDDDDDDDDDDDWDWD
DDDFDDDDDDDDDWWDDDDDDDDFDDIFDDDDDDDDFWWWWDDDDDDDDWWWDFDDDDDDDDDDDDMFDDDDDDIDDDGDDDDIFDDDFDWDDWWDDDDD
DDDMDDDDDDDFDDDDDDDDDDWWDDDDFDDDDGDFDDDDDDDDDDDDDDDFWWDDDDDDDDDDDDDDDDDDGDDFDDDDDDDDDDDDDDDDDDDDDDDD
DDDDDDDFDDDDDDDDDDDDWWDFDDDDWWWDDDDDIDFDDFDDDFWWFDDDDDWDDFDDDDDDDWDMDDDDFDDDFDWDDFDDDDDDDDDFIDDDDDMD
DDDDDDFDGDDDDDDDIDDDDDFWDDDDDDMDDDDMDWWDDWDDDDDDDDDDDDDDDIDFFDDDDWWFDDFDDDDDWDWFDWFDDFDDDDIDDFDDDDID
DDDDDDDDDDDDWWDDDDDDDFWWDDWWFDDDDIDDDDDDDWWFDDDDFDDDDWFDDDFWWWDDDDDDFDDDDDDDDDWWFDDDDDDFDDIDDDDDDDDD
DDDDDDDDDDDDDDDDIDDDDDGDFWDWWWDDDDDDDDDIDDDDDDDDDDDDDDDDDDDDDDDDWDDWWDDDDWWDDDDWWFDGFDDDDDDDWWFDDDDD
DDFDDDDGFDDDDDDDFDDDWWFDDDDDDDDDDDDWWWDDDDDDFDDDDDIFDIDDDWWWDDDFDDDDDDDDDDDDDDWWDMDDDDDDDDDDDDIFDDFD
DDDDDDDDDIDDWWDDDFDDDDDDWDDDDDDDDDDDDWWDDDDDDDDDDDDFDFWWDDDDDDWWFWWDDDDDDDDDDDDDDDDDDDDDWWDDDFDFDDWD
DDDDDDDDWDDDDDDMDDDDDDFDDFDDDDDDDWWDDDDDDWDDDDDDDDDDDDDDDFIDDDDDDWFDDDDDDDFDDWDDDDDDDDDDDDDDDWDDDWFD
DIDDDMDDWWDDDDDDDDDDWWWWDMDDWWDDWDWDDMDDWWDDWWFDDWDDDDDDDDDDDDDDDWDDDDDDDFWWWDDFWDDDMDDDDDDDDWWWWDDD
DDDWDDDDFDDDDDDDWWDDDDDDDDDDDDDDDWDWDDWWDDDDIDDDFWDDDDDDDDDDDDDDDWWFDDWWDDDDDDDDDDWDDDDDDDDDDDDIDDDD
DDDWDDWDDDDDDDDDDDDFDDDDFFWDIDDDDWWWDDDDDDDDDDDDFDDDDDDDFDDDFWDDDDDIDWWFWDFDFDDDDFDDDDDDFDDDDDMDDDDD
DDDDDDWWDDDDDDDDDDFWDDWWWWWFDDFDDDMDFDDDDDDDDDDWDDDFDDDDDGFDDDDWWWFDDDDDDDDFDMDDDFDWWDDDWDIDWFDDDWDD
DDDDDDDDDDDDDDDDDDDDDDDIFDDDDDDDDDDDDDDDDWDDDDFWWDFDDDDDDDDFDDIDDDDDDDDDFWDDDDDDDDDDDDDWWDDDWWFDDDDD
DDDWDDDFDDWDDDWDDFDDDDDDDDDDDDDDDDDDDFDDDWDDDDDDDDDDDDDFDDDDDDFDDDFDDDWWWDDDDDWDDDDDDFFWWDDDDDDDDDDD
DDDDDDFWDDDDDWWDWWWFDDDDFDDDDDDDDDDWWDDDDWDDDDDDDFWDDDWFDDFDDDMDWWWDFDDMFDDDDWWDDDDFDDDDDDDDWWDFDDDD
DWDDDDDWWDDDDDDFDDDWWDWWWDDDDDDIDDDDDDDDDWDDDDDDDDDDDDDFDWWDDDFDDDDWWFDDDDIDDDFDDFWWWDDDDDDDWWWWDDDD
DDDDDDDDDDFDDWDDDDDFWWDDDDDDDDDDDWWDDDDDWWWWDDDDDDDDDDDDDDDWWDDDDDWWDDIDDDDDDDDDDDDDDDDDDDDDWDDDWWDD
DDDGDDDDDDIFDDFDDDDDDDDDDFDDDDDDDWDDDDDDDDDDDDFWWFDDFDDDFWDDDDDFDDIFFDDFDDDDDDDDDDDDDDDDDDDDDDDDDWDD
DDDDDDDDDDDDDDWWFDDDDDIFFDIDDFWWDWWDDDDWDDWWDDDDDDDDDFDFDDDDDDWWWDDDDDFDDDDDDDDDDDDDDDDDIDDDDDDDFDDD
DDDFIDMFDMDFWWFDDDDDDWDDIDDDFDDFDDDDDDDWWDFWWFDDDDDDDDDDDFDDFWDWDDWDDIFDDDDDDDDDDFDDDWWDDDDDDFDDDDDD
DDDDIDDWWDDDDIDDDDDDDDDDDDDWWWDWWDDDDDDDDIFDDDDDDDDDWWDDDDDDDWWWFWWDWDDFWDFMDDDDDWDDDWWFDDFWWWDWDDDD
DDDDDDDFDDFDDDDDDDDDGDDDDDDDDDDDDDWDDDDDDDDFWDWDDWWFDWWDIDWWDDDDDDDWWFDFWDDDDDDDWWDWWDDDDWFDFDWWFDDD
DDWDDDDDDDWWFDDDDDDDIDDDDDWWFDFDDDMDFWFWDDDFWWDDDDDDFDDDDDDDFDFDDWWDDDDWDDDDFDDDDDDDDDWWWWDFDDDDDGDD
DDWWWDDDDDWDDDFDFDDDDDDDDWWDDDWWDDFDWWDDDIDDIDDDFDDFWWDDDDDDDDDFWWDDDDDDDDDFDDDDFWFMDDDMDDDDDDDIDDDD
DDDDDDDDDWFDDFIFWWWDDDIDDWDDDDDDDDWFDDDDDDDDDFDFDDDDDDWDDDDDDDWWDDDDDDDDDWWWDDWDDDDDFDDDDDDDDDDDDDDD
DIDDDDFFDFDDDDDDDDDDDDDDDWDDDDDDDDDDFDDDDDDDDDFDIDDDDWWWDDDDDWWDDDDDDDDDDDWWDDDDDDWDDFDFWWDDDDDDDDDD
DDDDDFIDDDDDWDDDWWDDDDDDDDDDDDDWDMDDWDDDDDFDWFDMDDDDDDDDDDDDDDDDDDDWDDDDFDWWDDDDIFWDDWWFDDDFDFWWWDMD
DDDMDDDDDDDDWDDDDWWFDDDFDDDDDFWWFDDFDDWFDDDDDFDDDDDFDDDFDDDDDDFDDDWWWDDDDDDMDDFDDWWDWWDDDGFDDIFDDDDD
DDDDDDDWDFDFWDDDFDDDDDDDDDDFDDDDDIDDDDDDDDDDDDDDDWFDDDDWDDDDDDWDFDDDDDDDDDDDDDDDDDDWWDDDDDDDDDDDDDDD
DDDMDDWWDDDDIDWWWFDDDDDFDDDWDDDDDDDFDDFDDDFFDDDDDDDDDDDWWDDDDFDDDDDDDDDDDDDDDDDIFDDDDDFDWWFDDDDDDWWD
DIDDDDDDFDDDDDWWDDDDDDDDDWWWDDDDDDFWDDDDDDWWDDWDDDDDDDDDDDDDDDDDGDDDDDFDDDDDDDDDIDDDDFDDDFDDDDDDDDFD
DDDDWWDDWFWWDDDDDFDDDWDDDDIDIDDDDFWWFDDDDDDDDWDIDDMMDWDDDWWWDDDDDDDIDWWDDDFDFDDDDDDDWFDDWWDDDDDDDDWD
DFDDFWWDDDDDDDDWDWDDDDDIDDDDDDDDDDDFDDDDDDDDDFDIDDDDDDMDDDDDDFDDDDDDDWWWDWWWDDDFDDWWDDMDDDDDDDWWWDDD
DDDDDWDDFDDDDDDWWWWFDDDDDDDFWDDIFDDWDWWDDDDFDDFDDDDDDDDGDDDDIDDDDFDDDDDDDDDDDDWWDDDDDDDDDDDFDDDDDDDD
DDWWWWDDDIFDDDDDWDDDDDDDDDDDDDDDWDWDWFFDDDDWWDWDDDDDDDDDDDDDDDDDDWDDDDDDDDDDDDDWWWDDDDDDDDWWDFWDDDDD
DWWDDDDDDFDMDDDFWFDDDDDDDDDDDDDDDDDIDDDDDDDDDDWWFDWDFDDDGDDDDDDFDIDDDDDDDDDDGDDDDDDDWDFDDIDDDDWDDDDD
DWWWDDDMDDDDDDWWWDDDWFWFDDDDDDDDDDDDMFDDDFDDDDDWWDIFDDDDDDDDDDWWDDDDDDFWWDDDDDDDIDDWWDDFWFDDDDWWWDDD
DDDDDFDFDDDDDDWDDDDDWDWWDDDDDGFDDFDIDWWDDWDDDFDDDDDDDFDDDDDDDDDWDDDDDDDFIDDDWDMDDWDDDDDWDWWWDDMDDDDD
DIDWDDDWWDDIDFDDDDDWDWDDDDDDDDDDFWDDDDDDFDDDWWDDDGDMDDMDDFFDDDWWDDDDDDDDFWWDWDDFDWWFDDDDDFDDMDDDDDDD
DDFDDDDDDDDDDDDFWDDFWWDDDDDDDDDDWWDDDDDDDDDDDDFDDDDDWDDDDWWDDDMFDDDDDDDFIDDDWDWWDDDMDDDDFDDDDDDDDDFD
DDDDFWWDDDDWDDDDDDDDFDDDGDDDDDFDDDDDWDDDFDDFDDWWWDDDWWDFWDDDMDDDDDDIFDDDDDDFDFWFWWDDDDDDDDWWWDDDDWWD
DDFDDDDDFDDDDDDDDDDDWWDDDDDDDDWDDDDDDDDDDDDMDDDDDDDDDDDDWDDDFFDDDDFDDDDDDDDDDWWDDDDDDDFDIDFDDDDDDDDD
DFWDDDDFDDDDDDDDWWDDFWFDDDDDDFDDDDFDDDDDDDDGDDDDFWDDDDDDWDWWWWFWDDDDDDWDDDDDWDDIDDDDDFDDDWWDDDDDDDDD
DDDDDDDDFDDDDWDDDDDDDWWDDDDDDDDDDDDDDMDDDDDDWWDDWDDDDDDFDDDDDDDWDDIDDDDDDDFDDDDDDDDDDDDDDDWDFDDFWWFD
DDDDDDDDDDDDDIDDDDDDDDDIDDDWDDDWDDDFDDDDDDDDDFDDDDDDIDWWDDDDDDDDFDDDDDDDDDDDDDIDDDFDIDDDDDDDWDWWDMDD
DDDDDDDDDDDDDDDDDDDWDDMFDDWDDDDDDDWWWDDDDDDMDDDDDDDDDDDDWWFGDDDDIDDDDDDDDDIDDDDDDDDDDDDDDDDDWDDFDDDD
DDDDDDDDDDDDDDDDDDDWWDDDDDFWDDDDDDDDDWWWWDDDDDDDGDFWWWDIDDWDDDFIDWDDDDDDDDFDFDDWFDDDWWWDDDDFWWWWDDFD
DIFDDDFDDDDWDDDDDDDDDDDDDDWWDDDDDDDDDDFDDDDDDDDDDDMDDDDDDDDDWWWDDWDDDDDFDDWWDDDWWDGDDDFDDDDDDDDMDDDD
DDDDFDWFMFDDDDDFFDDDDDDDDDDDDDDDDDDGDDDDDDDFWDDDFWDDDFDFWWDDFDDDDWWDDDDDDWWDDWWWDDDDDFDDDDDDDDDFWDDD
DDDDDFDDDWWFDDDWWDDFDDDDDDDDDDDGDDDFDDDDDDDDWWDDWDDDDDDDWDDFWDDDDIDDDWDDFDDDDDDFMDDDDDDDDFDFDDDDMDGD
DDDDDDDDDDDDDDWDDDFDDWDWFDWWDWDDDDDDFDDDWWWDDDFDDWFDDDDDWWWDDDDDDDWWWWDDWWFFDDFDDDDDWWWDDDDDDGDWDDDD
DDDDDDDDDDDDDDDDDDDDDDDDDDDDDDDDDDDDDDDDDDDDDDDDDDDDDDDDDDDDDDDDDDDDDDDDDDDDDDDDDDDDDDDDDDDDDDDDDDDD