;Map made by Santella Agustin
;element index
;  D : Diert
;  M : Mountain
;  W : Water

; starting the level:
DDDDDDDDDDDDDDDDDDDDDDDDDDDDDDDDDDDDDDDDDDDDDDDDDDDDDDDDDDDDDDDDDDDDDDDDDDDDDDDDDDDDDDDDDDDDDDDDDDDD
DDWWWDDDFDDDDDDDDDDDDWWDDDDDDDDDWWWWDDDDDDDDWDWDDDDDDDDWDDDDWWFDDFIFDDDDDIDMDFDDDDDDFDDDDWWDDDDDDDDD
DDDDDDDDDDDDWWDDDDDDFWFDWWDDDFDDDDDDDDDDDDDDDDDDDDDDMDDDDWWDDFDDDDDFDDDWDDDDDDDDWDIDWFFDDWWDDDFDDWWD
DDDIDDDDDDFDFWDDDDDDFDDDWDDFDDDDGDDDDDDWWDDWDDDDDDDDDDDFWWDDDDDDDDDDDDDDDDDDMDDDDDDDDFDDDDWWDDDDDDDD
DDDDWWDDDDFDWWWDDDDFDFWDDIDWDDDDFFDDDDDDDWWWWDDDDDDDDDDDDDDDDWWDFDDDDDDDDIDDDDIFDDDDDDFIDDIDDDDDDDMD
DDDDDDFDDDDDFDDDDDDDDDDDDFWWDDDWWWFWDDDDDDDDDDDDDDDDDDDDDDDDFDDDDDDDDWDDWFDDDDMDDDDDDDDDDDDDWWDDDFDD
DFMDDDWDDDDDDDDDIDDDDDDDDDDDWDDDDDFWDDDDIDDDDWWDDDWWWDWDDIFDDDDDDDDFDDDDDDDDDDDDFFDDDDFWFGDWWFDDWWDD
DWFDDWWDDDFDDDDDDDDDDWFDDGDFDDDDDDDMDDDDDDDDFDDDDDDDDDWDDDDIDDDDDDDIDDWDDDDDDDDWWWDDDDWWFDDDDDDDDDDD
DWWDDDFDDDDDWDDDDDDDDDDDDDWWDDDDDDDGFDDDDDDDDDDDWWDDDFWDDWWDFWDDDDDDFWWDDDDDDDDDDDDDDDDDDDFDDDWWDDFD
DDDDFDDDWWDDDDDDDDDDDDDDDDDDDDDDWDWFDFDFWWDDDDDDDFDDDFDDDDDDDWWDDDDFDDMDDDDDDDDDDDDDDDWWFFWWDDDDFDDD
DDDDDDDDDDDDDWDDDDDDDFDDDDDDWDDWWFWDWWDDWWWWWDDDDDDDDDDFDGDDDDDDDDDDDDDDDFDDDFDDDDDMIDDGDDDDDDDDDDDD
DDDDDDDDDFDWDWDFDDDDMDDFDDDWWDMDDWWDWDDDWDDDWWWFDDWDWWDDDDDFWFWDDDFDDDDDFDDDDDDDDDDDDDDDDDFDDDDDDDFD
DDDDDFDDWWDDDWWWDDDDDDDDDDDIDDDDDDDFDDDFDDDDDDDDWWWDDDDWDDDDDDWWDDWWDDDWWDWDDGDDDDDDDDDDDDDDDDDDFWWD
DWWWWWFDDDFDWWFDDDDDDWDFWWDDDDDDDDDDDDGDDDDDDDDFFDDDDDDWFDFDDDDDDDDDDDDDDFDDDDDDDDDDDDDDDDDDDWFDWWDD
DDIDDDDDDDDDDDDDDDDDWWDDDDWWDDDDDDDDWWFDDDDDDDDWWDDDDDDDDDDDDDDDMDDDDDDDDWDDDDDDDDDDDDDDDDDDDWWDMDDD
DDDWWDDWWDDDDDDFDDDWWDDDDDWWFDDDFDDDDDDMDDDDDDDDDDDDDDDDDDDDDDDFDFDFWDWDWWDDDDDDDDDIDDDDDDDDDDDDGDDD
DIDDDDDDWWFDDDDWDDDDDDDDDDDDDDDDWDDDDDDDDDDWWWWWDWFFDDDDDDDDDDDWWWWDDDWWDDDFFDDWWDDDDDDFMFDDDDDDDWWD
DDDDFDDDGFDDDDDWWDDDDDDDDDDDDDWWWDWFDDDDDFDDDDDDDDDDDDDDDDDDDDDDDDDDDDDDIDWWWDDDDIDDDDDWDDDDDDDDDDDD
DDDDDFWFDDFDDDFWWDDFWDDDDDDDDDFDDDWWFWWDDDDDDDDDDDDDDDDDDDDDDDDDDDDDFDDDDDDDDDDDDDDDIDDDDDFDDDDDFDDD
DDDDDDWDWWWFDDDDMDDDWWDDFDGDDDDDFDDDDDDFIDDDDIDDDDDDDDDDDDDDDDDIDDDDWWWFDDDWWDDDDDDDDDIDDFDDDDDDDDDD
DDDDDDWWDDDDDDDDDDDDDMFMDDDDDDDFDDDDDDDDDDDDDDWDFWDIDDMDGDDFDWWFDDWDDFDDDDDDDDFWWWDDMFDDDDDDDDDDDDDD
DDDDDDDDDMDDDDDDDDDDDDDDDDDDFDDDDWWWDDDDDMDDDDDDDDDDDDDDDDDIDDMDDFWWDDDDDWDDDDDDDDDDDDDDFDDDFDDFDDDD
DWDDDDDDDDDDDDDFIFDDDDDDDIDFMDDDFDDDDFDIFDDDDDDDDDWWDDDDDDDDWWFDDDGDWDDDWWDDDDDDDDDWWDDFWDDDDDDFDDWD
DDDDWWWFDDDDDDFDIFDFDDDDDDWWFFWWWDDDDDDDDDFDWFDDDDDDDFDDIDFWWDDDDDDFDDDDDDDDDDDDDDDDDDDDWDFDDDDWWDDD
DDFDDDFDDDDDDDWFDMDWWDDWDDDDMDDDDFDDDIDDDDWWWDDDDDDFDDDDDDDIDDWFDDDDDFDDDMDDDDDDDDDDDDDWWFWWDDDDDDDD
DDDDDDDDDWDDDDDDDDDDDDDWDDDDDWDFDDDDDDDDDDDDDFDDWDDDDDWDIFDDDDWWDDDDDGFDDDIDDDDDDDWWDDDDDDFDDDDDDIDD
DDFDDDFDDDDWDDDDDDDDWWFDDDDDDWWWFDFMDDDDFFDDDWWDDDDDDDWFDDDDDDDDIDDDWDDDDDDFDDDDWWFDDDDDWWWDDDDDDDDD
DDDDDDWWDDWWDDDWWDDDDDDDWWDDDDDDDDWDWWDDWWDDDDDDDDIDDWWFWDWWWDDDDDIDDMDDDDDDDDDDIDDDDDDDDDDDDDDDDDDD
DDFDDDDDDDIFDDDDDFWWDWDWWWDDDDMDDWWWDDDDDDDDDDFDFDDWDDDDDDDDDDDDDDDDDDWWDDDDDDFDDFWDDDDDFDDDDDDWDMDD
DDWDDDIDDDDDDDFDDDDDDDDWDIDWWWDDDDDFDDDIFWDDFWDDWDWWFDDDDDMDDDDFDDDDDDDDDDDDDWDDDDDDDDDDWWDDDDDWFFDD
DWFDDDFDDWDDDFWWDWWDDDWWWDDDDDDDDDDDDDDDWWDDWWDWWDDDWWFDFDDDDWWWFDDDDDDMDDWWWWWFDDDDDDDDDDDDDDDDDDDD
DWWFDDDDDDDIDWFDDDDDWWWDDDWDDDDDDDDDDDDWDDDDFDDDDDDDDDDDWDDDDDDWDDDDDDDDWWDDDDWDDDDDDDWDDDDFDDDDDWDD
DDDDDDDWDDDFDDGFMDDDDDDDFDDDDDDFWFDDFDDDFDDFWWDDDDDWFDDDDDDDFDDWFDDDDWDMDDDDDDWDWDDDDDDDDDDWDDDWWWWD
DDDDDDFWFDDDDDDDFDDIDDDDDDDDDGDFDDFDIFDFDDDDDDDDDDWWDDDDDDDDFDDDDWDDFWWFDDDWDFDDWWFDWWDDDIDMDDDDDDWD
DDDDDDDDDFWDFWWDDDDDWDDDDDFWDDDFDDDDFWWWFDDDDDDDDDIFDDDDDDDDWWDDFWDDDDDDDMDWWDFWDFDWWDDWDDDDDDFDDDDD
DDDFDDGDDDDDFWWFDDDDWWDDDDDDDDDWWDDDDWDDDDDDDDDDDDIDDDWFWDDWWDDDFDDDDDDDDFDDDDDWWWDDFDDDDDDDWDDDDDDD
DDFDDDDDDDMDFDDDDDDDDDDDDDDDDWDDDDDDDDDDDMDDDDDFDDDDDWWDDDDDDDDDDDDDIDDDDWWDDDDIDWWDDIDDDDDDWDDDDDWD
DDDDDDDDDDDDDDWWDDDDDDDDWWDDDDDDDDDDDDFDDDDDDDDDDDDFWDDDFDDDDDDMDDDDDDDDDDDDDDDDDDFDDFDDDDWFWWWDDDDD
DDDDDDDDDDDDFWWDDDDDDDDWDDDDDDDDWDDDIDDFDDDDDDDDDDDWWDDDDDDDDDDFDDFDDDDDDDDDDDWWDDDDDIDDDWWFDGDDDDDD
DDDDDWDDDDDDDDDDDFDDDDDGDDDDDDDDDDDDDWWWDWWFDDDDGDDDDDDWWWDDDDWWFFDDDDDMDDDDDWWDDDDDDDDDWWFDDDDDDDDD
DWDDDDDDDDFWDDDDWWDDDDDDDDDDMDDDDDDDFDDDDWFWWWDDDDDDDDDWDDDMDMDDDDDMDFDDDDWWFDDDDDDDDDWWDFDDDDDDDDDD
DDDDDDDDDDDDDDDDDDDFDDDWDDDDDDDDDDFWDDDDWWDDDDDMDDDDDDDWDDDDDDDDIDDDDDDDDDDDDDFDDWDDDDDDDDDDWDWWDDDD
DDFDDDDDDDWDDDDDDDWWFDDDFDDDFDDDDDDDDDDDDDDDDDMDDDDDDFWWDDDMDFWDFFDFDFDDWDDWDDWWDWWDDMDDDMDDDDDDDDGD
DDDDDDDDDWDDDDDWWWDGFIDDWDDMDDIDDDWDDWWDDWWWDDFFDDDDDDWDWDDDDFWDWWFWDDDDDDDWWFDDDDFWDDDDDDDDDDDDDDDD
DDDGDDDDDDDDDWWDDDDDDDWWWDDDDDDDDDDFDDDDDWFDFWWWWFDDDMDWWWDFDDWDDWDDFDDDDDDDDDGDDFWWDDDDFDDWWDDDDDFD
DDDDDFDDDDDDDDDDFIFDDFWFDDDDDDDDDFFWDDDDDDDWDDDDFGDFDDDDWDWWWDDDFWWFDDDDDDDDDDDDDWDDDDDDDDDDDDDDDDDD
DDFDDDDDDDDDDDDDDDDDDDDDDDWWDDDDDDDDDWDWWDDWWFDDIDDDDDDDWDIDDDDFDDWWWFFDDDDDFDFDDWWDDDDWWDGDFDDDDDDD
DWWDDDFDDFDDMDDDWWDWDDDGDDDDDDDDDDDFDMDDDDDDWWWDDMDDDDDDWDFWDDWWDDWDDDWDDDDWWDWWDDDDFDDWWDDWWDWWWDDD
DDDDDFDDDFDDMDFDDFWWFDDDDDDFDDDWDDDDDIDWWWDDDDDDDDDWDDDFDDWWDDDDWDWWWDWDDDDDDWWDWDDDWWWDDDDDDDWWWDDD
DDDDDDDDDWWWDWWDDFDDWWWDFDDWDDDWDDDDDDDDDDFDDDIDDDDDDWWDDDDWDDWWDDDWDFDDWWDDDDFWWFDDDDDDDDMDDDDDFDDD
DFDDDIDDDFWFWDDDDDDDDDDDDDDDDDDDDDDDDDDDDDDDDDDWDDDDDFDDDDDWDDDDDDWWDDDDDWDDFDDDDDDDDDFDDDDDDDDWWDMD
DDDDFDDDDWWDWWDDDDDDDDDFDFDDDDDDDDDDDFDDDDDDDDDWWWFDDFDDWDDWDDDIDDFDDDDDDWWWWDDDDDDDDDDDDDDDDDDDDDDD
DDDDIDDDDDDDDDDFDDDDDDDWFDDDDFDDDDDDWWDDDDDDDDWFDDDDDIDWWDWWWWFDDDWDWWDDIFFDDDDDDDDIDDDDDDDDDGDDDDDD
DDFDDDDDDDDWWWFWDDDDDDDWWDMDDDDDDDDDDDDFDDDDDFWWDDDDIDDFDDFDDDDGFDDDDDDDDDWWWWDDFDFDDDDDDDDDDDDDGDDD
DDDDDDDDDDDDDIFDDDDDDDDWWDDDDDDFIDDDDDDDDMDDDWDDDDDWFDDDDDDIDDDFWWDIDDDDDDFDDDDDDDWWDDDDDDDDDDDDDDDD
DDDDDDDDDDDDWDDDDDDDDDDDDFDFDDDDDDWDWWWDDDDDDDWWFDFWDFDDIDDDDDDDDDDFWWDDDDDDDDDDDDDDDDDDDDDDDDDDDDDD
DDDDDDIDDFDDWWWDDDWWDDDDDDFDDDDDDDDDDDDDDDDDIDWDDDDDFDDDDMFDFDWDDMFDDIDDDDDWFDDDDDDDDDDDDMDDDDDDDDDD
DDDDFDDDDDDWWDMDDDDDDDDWDDDDDDDDDDDDDDDWDDDDDDWDDDDDFDMDWDDDDFDDDDIDFDDDDDDWWDWWDFWWDDDDDDDDDDDDDDDD
DDDDDDDDDDDDDDDDDDDDDDFWWDDWDDFDDDDDDWDWWDFIDDDDDDFDWDDDDDDDDDDDDDDFDDDDGDDFDFDFDDDDDDDIFDDDDMDDDDDD
DDWWWDDFDDDDDDDDDDDDDDFWWWDDDDWWDGDWWWWDDDDDDWDDDDDDDFWDDDWWDWDDDDDDDFDDDWDWWWDDDDDDDDDDDDDFDFWWFDFD
DWWDDDDWWDDDDDDDDDDWWDDDDFFDWDDDFDDDDDWDDDDDWWDDDMDDDDWDDDDDDWFDDDDDWWWWDDDDIDDMDWDDDIDWWDFDDDDDDDDD
DWDDDDDDDDDDDDMDDDGDWDIDWWWDDDDDWDDDDDDDDDFDDDFWWFDDDDDDDDDFDDDDDDIFDDDDDDDDDIFDWDDDDIFDDDDDDDDDDDDD
DWFDDDDDDDDDDDDDDDDDDDDDDFWWFDDDDDDDFDDFDDDDWFDDDDDDFDDDWWDDDFDDDDFDDDDDDWFDFDDDDGDWWDDDFDIDWWDDDDDD
DWFDDDDDDWDDFDDFDDDDDDDFDDDDDDWWDDDDDDDDDDFDDFWFDDFIDDDDDDDDWWDWDDDDDMDDWWDDIDDDDDDFDDDDDDDDDGDMDDDD
DDIDDDDDWWDWWFFWWWWDDDWWDDDDDDDFDDDWWWFDDDDDDDWDFFDDWWDDDWFDWWDWWDDDDFWWDDDDDDDDDDFDDDDDDWDDDDDDDDDD
DDDDDDDDDDFDDFWWWDDDWWFDDDDDDDDDDDDDDDDDWWFDFWWDWFDFDDDDWWDDDDDFDDDDWWWDDDDMDDDDDDDDDDDDDWWDDDDDDDDD
DWDDDDDMDDDDDDDMDDFDDDDDDDDDDDDDDDFDDDDFDDDDDDDDWWDDDDWDDDDDDWWFDDDDDDDDDDDFDDDDDDFDDDDDWWFDDDDDDDDD
DWWWDDWDGDDDIDFDDWWDDWWDDFDDDDFIFWFDIDWWWFDFDDWDDDDDDDDDDDDFDDDWDDDDDDDDDDDFFDDDDDDDDWDDDDDDDFWWDDDD
DDDWWDDDDDIDDWWDDDDDDDFWDWDDDWWDWWFDDDWFDDDDIDDDDDDDIFDDDDDDDDDDDDDDDWDDWDFWWDDDWWFDDDFDDDDDDWWDDDDD
DDDDFDDDDIDDDDDDDDDDDDFDDWDDDDDDDFDDFWWDDWDDDDDWDDDDDDDFDDDDDDDDDDDDFDDDDFDDDDDDDIDDDDDDDDWWDWFFDDDD
DDDDDDDDDDFDFWDDDWWDDDDDDDDDDDWDWWDDDDDFWDDDDDDDDMDDMDWWDDDDWWDDDDDDDDDDDDDDDDDDDMIDDDDDIDDDDWDDDDDD
DDDDDDDWDDWWDWWDDDDWWDDFDDDDDDWWDDWFIDDDWWDDDFDDDDDDDWWDDDDFDDDDFDDDDDDWWDDWDDDDDDDDDDDDDDDWWWWDDWWD
DDDDWDFDDFDDWFDDDDDDMDDDDDDDWFDDWDWWDFMDDFDDDDDDMDDDDDFWDDDWWWWDDDDDDDDWWDDWWDDDDDDDWDDFDDFDDDDDDDFD
DDDDDDDDDFDDDWWWDDDDDDDDDDDDWDDDWDDDWWDFDWWDDDWDFDDWDDFDDGDDDWWFDDDDDDDDDDDDDWDDDWFDDDDDDFDDDDDIDWWD
DDDDDDDDDGDDDDWFDDDMIDDDDDDFDDMFWDDDDDDWDDDDDDDDDDDDDWFDDDDDDDDDDDDWWWDIDIDFWWDDDDDDDDDDWWDGDFDDDDFD
DDIDDDGDDDWWDDDDDWWDDDDDDFDDDDFFDDDDDDDWDDDWWWDDDDDDFDDDWDDDDDDDDDDWWWFDDDWWWWWDDDDFWWFWDDDFWWDIDDDD
DWDDFDDDDDDDDDDDDDDWWDDDDDFDDWWDDDDDDFDDDDMDDDDDDDDFDMDDWFWDDDDDDDDDDDDFWWDDDDDDGDDFDDDWDDDDDWDDDFDD
DWDDDDDDDDWDDDDFWWWWWWDDWDDDDDDDDDGFDDDDWWDDDDDDDDDDDFWWFDDDDDDDDDDDFDDWWDWWDDDDDDDDDWWWWDDWWDDDDDDD
DDMDDDDDDDDDDDDDDDDDDDWFWWDFDDDDDDDWDDWWFDDDDDDFWWDDDDDDDFDDFDDDDDDFDFWWFDDDDDDIDDFDDDDDWDDFDDFIDDDD
DDDDDDDDDDDDDDDDDDDDDDDDDDDDDDDDDDDDDDDDDDDDDDDDDDDDDDDDDDDDDDDDDDDDDDDDDDDDDDDDDDDDDDDDDDDDDDDDDDDD