;Map made by Santella Agustin
;element index
;  D : Diert
;  M : Mountain
;  W : Water

; starting the level:
DDDDDDDDDDDDDDDDDDDDDDDDDDDDDDDDDDDDDDDDDDDDDDDDDDDDDDDDDDDDDDDDDDDDDDDDDDDDDDDDDDDDDDDDDDDDDDDDDDDD
DDWFDFWWWDDDDDDFWWWDDDDDGFDDDIDDDDDDDDDDFDGFDWWFDFDWDDDWWWWFDDDDDDWDFDDDDDDWDDDDDDDDDDDDFDDDFDDDDWWD
DWDDDDDDDDDDDDDFDDDWWWFFDDDDDFDDDDDFDDDDWWFDWWDMDWDWWFDDDDDDDDDDWFDDDDDDMFDDDDDDDDDDFDDDFDDDDMDDWWDD
DWWFDDDDDDDDDDDDDDDDDDWWDDDMDWWDWWDDDDFWDDWDDDDDDDDDDDDDDDDFDDFWWDDDDDDDDDDDDDDFDDDFWWDDDDDIDDDDDDDD
DDDDFDFDDDDDDDDDWDDDDDDDDDDDDDIDDFDDDWDWWWWDDDDDDFDDWWDDDDDWWDDDDDDDDWDDDDDFDDFDDIDDDDIDDDIDFFDFDDWD
DDDDWDDFDDDDDDDDDDDDDDDDDDDDDDDDDWWDDDDFIDDDDDFWDDFDDDDDFDDDDDDDDDDDDDDDDDDDFWWDDDDDFDDDDDMDWWFDFDDD
DDDDDDDGDFDDFWWWDDDFWDDDDDIDWWDDDGDDDDDDDDDDDDDDDDDDDDWDDDDDDDDDDDDDDDFDDDDFDDDDDDDWWDDDDDDDDDDDDDDD
DDWDDDDDDDDDDDFDDDDDWWDDFDDDGFDDDFDDDDDDDFDWDDDDFDDDDDWDDDMDDWWFDDDDDFDDDDDDFDDWDWFDDDDDWWDIDIDIDDDD
DDWWFDDDDDDDDDWDDDWWDWWDDDWWDDDDFDDDDDDDDDDDDDDDWDDDFWWDDDDDDDFGDDDDDDDDDDDDDDDGDWWWDDDDDDDDDDWDDDDD
DDDDDDDDWWDDDDMDDDDDDDDDDDDDDDFDDDWWFDDDFDDDDDDDWDDDDDDDDDDDDDDDDFDDDMDDIDDDDDDFDDDDDDDDDFDDWDDDDIDD
DMDDFDDDWDDDDDDDFDDFDDFDDDDDDDDDDWWDDDDWWFDWWWDDDDWFFWWFDDDIDWDDFWDDDFDDDGDDDDFDDFDDDDDDDDDFWWDDDDFD
DDDDWWFWWDDDDFFDDDFWDWWWDDDDDDDDDDMDDDWWFWDDDDFWDDWDDDDFDDDDDGDDFWFDDWDDDDDWWFDDWWFDFIFDDDMDFDDDDWWD
DGDDDWDDDFDDDWWDDDDWWDDDDWWWDDDDDDDDDFGDFDDDDDDDDDWWDWWWWDDDDDDDDDDDDDDDDDWDDDDDDDDDDDDDDIDDWDDDDFDD
DDDDDWWWDWDDMDDDDDDDDDDDDDFWDFDFDDMDWDDDDDDDDDDDDDFWDDDFWDDDDFDDDDDDFDDDDWWWDDDMDDWWFDIFDDDDWWDDDDDD
DDDDDDDDWWDDDDDIDFDDDFDDDDDWWDDDDWFFDDDDGFDDDIFDDDDWWDDDDDDWFWWWWFDDDDDDWDDDDWWDDDWWDDDFDDDDDWDDDDDD
DDWFDDDDDWWFWDDDDDFDDDDDDDDDDDDDDWWDIDDMDDDDDDDDDDWDDDFDDDDDDDDDDDDDDDDDWWDDDFDDDDDDDDDDDDDFFWWDDFDD
DDDDWWFMDDDWDDDDDDDDDFDFWWWDDFDDDDWDDDFDDIDDDDDGDDDDDDWDDDDDDDDDDDDWDDDDDDDDDWWFDDDDDDWDDDFDDDDDFWWD
DDDDDFIDDDDFWWFDDDDFWWWFDDDDDDDDDDDFDDDDDDDIDDDDDDDDFFDDDDDDDDDDDDDWDDDDDDDIDDDFDDDWWFWWDDDDWWDDDDDD
DDDDDDDWWDDDDFDDDDDWDDFWDFDDDDDDDFDDDDDDWDDDDDDWDDDFDDDFWDDDDDDDFDDDDDWDFDDDDDDWWDDDDDGFDDDWWDDDDDDD
DDWDDDWDDDDDDFDDDDFWWDDWWDDDDDDDFDDDDDDFWWFDDDDWWDDDDDDDDDDDDDDFDDDDDDWDDDDWWDDDDDDIDDDDDDDDFWDFDDDD
DDDDDDDDDDDDDMDDDDDDDDDDDDDDDDDDDDDDDDWWDDDFDDDDDDDDWWDDDDDIDDDDMDDFDDDDDDDDDDFWDDDDDFFDDDDDDDDDDDDD
DMDDDDDDDDDDDDDDDDWDDDDDDDDDDDDDDDDGDGDDDDDWDDDDDWDDDDDDDIDDWWDDFDDWDDDDDDDDDDFWWDDDDWWFDDDDDMDDDDDD
DDGFDDDDDDDDFWDDDFDDDDDDWWFDDDFDDDDDIDWWDDFWWFDFWDDFDDWDDDDWWDIDDDFDDDDDDDDDDDDDDDDDDDDDDDDWWDDDDDDD
DDDDDDDDWWDDDDDDDDDDDDDDDFWDDDDDDDDDDDDDWWDWFDDDDDFDDWWDDDDDDWDDFDDMDDDDDDDDFWFDWWDDDDDDDWDDDWFDDDDD
DDDDDFDDDDDDGDFDMDDDDDDDDDWDDDDDDDDDDDDDDDDDFDDDDDWDWWWDDFDDWWDIDDDDDDDDFWWFDWDDDWWDDDDIDWDMDIFDFWWD
DDWWWWFDDDWFFWWDDDDDDDIFDDDDDDDDDFWWWDDDDDDDWWWFDWDDDDWWDDDDDWWDDDDDDDDFDFWDFDDDDDDDFDDDFWWDDFDDIDID
DDDDFDDDIDWWDDDFDDWWDDFDDDDDDDDDDDDDFDMDDDIDWDWDWWWWWDDFDDDDDDDDDDDDDDDMDDDDDDFWWDDFDDDDDDDDFGDDDDDD
DDDDWDDDDMDDDIDDDDFDDDWWDDDDDDDMDDDDDDDDDDDDDDDDWDDDFDDDDDDDDFFDDDDDDDDDWWDDDDFDDDDDDDFDDDFFDFDDDDDD
DDDWWDDDDDDDDDDDWDWDDDGDDDGDDDDDDDFDFDDDDFDFDDDDDDDDDDDDDDWDWWWDDDDFDDGDDDWWDDWWDDDFDDDDDDWWFDMDDDDD
DFFDDDDWDDDDWDDDWDDDDDFDDDDDDDDDDDDDWDDDFWWWDDFMDDWDDDDDDWFDDDDDDDDDDDDDDDDDDDDMFWDDDDDDDDDDWDFFDDDD
DWWDDDWWDDDWWWDWWWFDDDDFDFDDDDDDFDDDWFDDDDDDDDDDDDDIDDDDDWWDDDDDDDDDDDDDDDDDDDDFDWDDDDDDDDDWWWWWDDDD
DIDWWDDDWDDDDDDWFDDDWDDDFDDDDDDDDDDDWDDWWDDFWWDDMDDDDDDMDDDDDWDDDDWFDDDDDDDDDDWWDWWDWDDDWWDDDFDDDDDD
DIFWWDDDDDDDFDWDDDDWWDWWWDDDDFDIFDDDWWDDDDDDDDDWFDDDDFDDDDDDWWFDDDDDDDDFDDDMDDDDDDDDDDDDDDDDDWWWDDDD
DDDDDFDDDFDDWDWWDDDDDDDDDFWWDWWDDGDDDDDDDDDDWWDDDDDDDDDDDFWWDDDDFDDFWWDDGDDDDDDDDDDWDDDDFDDDDDDDIDDD
DWDDWWWWWWDDDDDDDDDDDDDDDDDDDDIFGDDDDWWDDDDDDDWFDDDFDDDDFDWWDDDDDDDDWWWDDDDDDDDDDDFWDDDFIDDDDDDDDFWD
DIFWDDDDFDDDDDDDDDDDDDDDDDFDDDDDDWDDDWWDDFDDDWWDDDWWWDDDWWWDDDDDFWFDFDDDDDDDDDDFDDDDFDDDDDDDDDDFDDDD
DDDDDDDDDDDDDWWDDDDDDIFDDDGFDDDDDDDDDDDWFWWWFDDDDDDDDDWWDDDDDDFDDDFDDDDDDDDDDWDDDDDDWWWDDDDDDDWWDDDD
DFWDDDDDDIFDWWDDDDDDDDWDDDDDDDDDDDDDDDDWDDMDDDDDDWDDDWDDWWDDDDWDDDWDDDDDDDDDDDDGDDDWDDDIDDDDIFDWFDDD
DDDDDDDDDDWWWFDWDDDDDWWFDDDDDDDWWDDDDDWDDDDDDDDDDDDDDDDDWDDDDDDDDDDDMDGDWWDDDDWDDDDWDDDDDDDDDDFDDDFD
DDDDDDDDDWWWDDDWWWWFDDFDDDDIDDDDDWDDDDDWWFDDDDDWWDDFDDWDWWFDIFDDDDDDDDDDDWDDDDDDDDWWDDDDDFIDDWDDFDDD
DDWWDDDWWDFDDWDDDDWWDWWDDDDDDDDDDDDDDDDDDFMDDDDDDDWWFWDDFMDDDDDDDDDDDDWFDDDDFDDDDDDDDDDDDWDIDWDWWFDD
DDDDDDDDDDDDDDDDDDDFDDDDDDDDDIDDDDWWDDDWFDDDDDWWDDDDDFDDDDDFWWWFDDDDDDWDDDDWWWDDDWDDDDDDDDDDFMDDDDDD
DDFDDDDFDDDDDDFDFDDDDDDDDDDDDDDDDWWFDDDWWDDDDWWWWDDDDDDDDDDFDDDDDFDDDDDDDDDDDWWDDWWDDDDDFDWDDDDDIDFD
DDWWDWWDFDDDDDDDDDDDDFDDDDDMDDDDDDDDDDDWWDDDDDDFIDDDDWDDDDFDDDDDDDDDDWFDDDDDWWWFDDDIDDDFDDWDDDDDDDDD
DDDDDDFWWDWDDDDDFDDDDWDDIDDDDDDDDDDDDDDDDDDGDDDWFDDDWDDDFDDDDDDDWDDDDWWDDDDFDDDWDDMDDDWDDDWDDDDDDDDD
DDDDDDDMDFDDDDDDDDWDWWWFDGFWDDDDDDWWDDDDDGDDDDDWWDDDDWWDWDDDDDIDDDDDWWFDDWWWDDDDFDDDWWWWWFMFWWWDDGDD
DDWDDMIDFWDDDDDDFWWDDDDDDDWWWFFDDDGDDDDIFDWWDDFDDDDDDDDFDDDDDWDDDDDDDDDFFDFDWDFFDDDDWDDDDDDDDWWDDDDD
DDDDDDDDWDDDDDDDDDDDDDDDIFDDDDWWDDDDDDDDDDDDDDDDDFDDFDDDDDDDDDDDDDDMDFFDDDDDDDDDDDDDMDDDDDWDDDDDFDDD
DDDDDDDDDDDDWWFFDDDFDFDWDWDDDDDDDFDDFWDWDDDWDDDFDDFWWDDDDDDDDIDDDDDDDWDFWDFDDDFFDDDDDDDDFWWFDDDDDFGD
DWWDDDDDDDDDDFFDDDDIDDDDDIDDDDDDDDDDDDDDDDDDDDDDDDFDDDDFDDDDDDDDDDDMDWFFWWDDDDWWDWWDIDDDMFDDDDIFFDDD
DDDDDDFWDWWDWWFDFWWDDDDDDDDDDDDDFDDDDDDDDDDDDIFFDFDDDDDDDDDDDDDDDDDDWDFWWDDDDDDWFDDDDDWWFDDDDDGDDFDD
DDDDDDFWFFGDDFDDDDDDDDGDDDDDIDDDWWDDDGFWDDDDDDFWWDGDDDDDDDDWDIFFDDIFDWDDDDDDDDDWDDDDDDDDDDWWDDDWDDDD
DDDDDDDWWFFDDDDDFDDDDDDDDDDDDFWWWDWWDDDDDDMDDDDDDDDDDDDDDDDWDDWWWDDDDDFWWDWWDDWWWWDDDDDDDDDDDDWWWDDD
DDDDDDFDDDDDDDMDDDWWDDDFDDDDDDDDDDWWDDDDDDDFDIDDDDDDDDDDDFDDDDDDDDDDDIDWWFDDDDDDDDDDDDDDDDDDDMDDWWWD
DDDDFDWWDDDDDDDDDDDDWFDWDDDDDDDDDDDFDDDDDDDDDDWWDDDDDDDDDDDDDDDDDDDDDDGDDDDDDDDDDWDDDDFWDDDDDDDDDDDD
DDDFDDDDDDDDDDDDDFDDWDWWWWFWWDDDDDDDDDDDDDDDDDDDDFDFDFDDDMDWFDDDDDDDDDDDDDDDDDDWDWWDDDWWDDDDDDFDDDDD
DDDFDDDDDDDDDWDDWWFDWWWDDFDDDDDDDIDDDDDDDDDDDDDWWDDDDDDDDDWWDDDDWWDDDDDDDDDDDDDDDDIFDDDFDDFWWDDDDDDD
DDDWWDDDWDFDDWWWDDDDFDWDWWDDIFFDDDGDDDDDFWDDDDDWWDDFWDFDDIDDDDDDDDDDDDDWWDDGDDDDDDDDWDDWDDDDDDDDGDDD
DDDWWDFFWWWWDDDWDFDDWWWDDDDDDFDDWWFDDDDDDWWDFDIDDDDWWDDDDDDDDFWWFWWDDDDDWDDFDDDDDDDDWDWWDFWWDDDDDDDD
DDDDDWWDDDDDDFWDDDFWWWDDDDDFDWDFDDDDDDDDDDDDDDDDDDDDDDDFFIDMDDIDDDDDWFDDDDDDDDFDDDDDWDDDDDDMDDDDDMDD
DDWFDDDFDDDFDDDWDDDWWDDDDWFDDDDGDDGDDDDMDDDFDDDDFDDDDDDWWDDDDDFDDDDDDDWDDDDWWFDDDDWFDDDDDDDDDMDDDDDD
DDDMFDDDDWWWDDFWWDFDDDDFWWDDDDDDDDDDDDDDWWDWWDDDDDDDDFWFDDDDDDWWFDDDDFWFFWWDDDDDDDWWDDDFGFDDDDDDDDDD
DWDDDFDWDDDDDDWWDDDDDDDDDDWWDDWDDDDDDDDDDDGDDDMDDDDDDDDDDDDDWWDDDDWDDFWWWDDDDDDDDDFWWDDDDDFDDWWWFDDD
DDFDDDDDDDDDDDDDDDDFDDDDDDDFDDDDIFDDDDFDWFDDDDDDDDDDFDDDDGDDDDDIDDDDDDDDDDFFDDDDDDWWFDDDDDDDDDDDDDDD
DDDGDDDDDDDDDDDDDDDWWFGDDDWWDDDDDFDDDFDDWDDIDDDDDDDDDDDDDDDDDDDDDDDDDDDDDDWWDDDDDDWFDDDDDDDDDIDDDDDD
DDDDDDDFDDDDDDDMIFDDDDDDDFDDDDDFWWWDDDDDDDDDDDDDDDDDFDDDDDWDDDDDDDDDDFWDDDDDDDDDFDDDDDDWFDDDDDWWWDDD
DDDDFDDDDDWWDDDDDDDDDDDDDDDDDDDDDDDDFDDDDDDDDDFDDDWWFDWDDFDDDDDDDWWDDFDDDFDDDMDDDDDDDDDWDDDDDDDDDDFD
DDDDWDDDWDWWDDWDDFDDDDWWWDDDDDDGFWDDDDDDDDFDDDWDDDDDDDWWDDDDDDDDDDDDDDDDDWDMDDDDFDFDFDDWWWWDDDWFWWDD
DDDFDDDFWWDDDFDDDWWDDWDDDDDDDDDDDWFWDDDDDDDDDDWDDDWFDDDDDDMDFDDDWWDDDDDGDWDDDDDFMDDDDDDDMDDWDDWDDDID
DDDDFDDDDIDDDWDDWDFDDWDDDDDWDDDDDDDWWWFWWDDDDWWWDDWWDDDDDDDDDDDDDDDDDDDDDDDDDDDDDDDWDWWDDDDWDDDDDFDD
DDDDWDDDDDDWDDDWWDDDDDDDDDDWWDDDGDDDDFWDDDDDDDDDDFDDIFWWDDDDDIDDFDIDDDDWWDDDDFDDDDDWWDDDDDDWWDDDDDDD
DDFWWWDDDDDWDDFWWDDDDDDDDDDDFDDDDDDDDWWWDDDDDDFDDDDDDMDDDIDDWDFDDDDDDDDDDWWDWWDDDFDDDDDWDDDDDDDMDDDD
DDDDDDDDFDDDIDDWWFDDDDDDDDDDDDDDDDDWDDDDWWDDWWWDDDDDDDDDDDDFDDDFDDDDDDDDDDDDDDDDDDDDDDDDDDDDDDFDDDDD
DFDDDDDDDDDDFWDMFDDDDDFDDGDDDWWDDDFWWDDGDDDFWWDDDFDDDDDDDDDDDDDDDDDDWFWDDDDDDWWDFWWWWDDDDDDDDDDDFFDD
DDDMDDDDDDWFDWWDDDDDDDDDDDDDDDWWWDDFDDDDDDDDDDDDDWWDDDDDDDDDDDIDDDDDDDWWFDWDDFDDFDDDDDDDFWDDFDDDWWFD
DDDDDDDDDDDDWDDMDDDFDDWWFDDDDDDWDDFDDDFDDDDDDDDDDDDDDWWDDWWDFWDDDDDDDDWWFFDDDDDDDDDDDDDDDDDDDDFDFWDD
DWWDDFDDDWFDDDDDDDDWDDDIDDFDDDDWFDDIDDDDDDDDIDDDDDDMDDDDDFDFWWWWWDWFDDDDDDDDDMFDDDDDDDDDDDDDDDWWWWFD
DWWDIFDDDWFIDDDDDDDDDDDDDDDDDDDDDDDDDDDDDDDDDMDWFDDDWWDDDWDDDDDDDWWFDDWWDDDDMDDDDDDFDDGDDDDDWWDDDDDD
DDIDDDDDWWDDDDDDDDDDFDDDDGDDIDIDWDDDWDFDDDDDDDFDDDDFWDIFDDDDDDDDDDDDDDDDDDDDFWWFMDDWDDDDWWDDDDMDDDDD
DDDDDDDDDDDDDDDDDDDDDDDDDDDDDDDDDDDDDDDDDDDDDDDDDDDDDDDDDDDDDDDDDDDDDDDDDDDDDDDDDDDDDDDDDDDDDDDDDDDD