;Map made by Santella Agustin
;element index
;  D : Diert
;  M : Mountain
;  W : Water

; starting the level:
DDDDDDDDDDDDDDDDDDDDDDDDDDDDDDDDDDDDDDDDDDDDDDDDDDDDDDDDDDDDDDDDDDDDDDDDDDDDDDDDDDDDDDDDDDDDDDDDDDDD
DDDDDDDDDDWWDDDDDDDDDDDDGDDDDDWFDWDWWDDDDWWDIDDDDWDFDDWDIDDDWWWWWFDDDWDDDFDDDFDDDWDDDDDDDDDDDDDDDDFD
DDDWFDDDDWDDDDDDDDDFDFDDDDDDDWDFDDFDDDWWDWWDDDDWWWDWDDWWDDDDFFDDDFDDDDDFWWFDFDDDFWDDDDDFDGDDDDDWWDWD
DDDDDDDDDWWFDDDDDIDDDWDDIFDDDFWWDDWWWDDDDFWFDDDDWDDWWFDDDDDDWWDDWWWFDDDDDMDDDDDFWWFWWDDMDDDDDDDDDDDD
DDFDDDDDWDDDDWWDDDWFFGDDDDDDDDDDDDDDDDMDDDWDDDDFWWDFWDFDDDDDDDDDDDDDDDDDDDDDDWFDDDWWDDIDWWWDDDDDDDDD
DWWWDDDWWWDWWDMDDDDDDDDDFDDDWDDDDDDDFDDDDDDDGFWWFDDWWDDDDDDWWDDDDDDDDDDDDDDFWWFDDDWDDWDDDDDDDDDDWFDD
DDDDWDDWDDDDDDDDDDFMFWFFWWDDDDDDDDDWWWFDDDDDFDDDDWWDDFDDWWDDDWDDDDDDDDDDDDMDDDDDDFDDFWDDDDDDDDDDDDDD
DDDDDDDDDDDWWDDDDDDDWWFDDDDDDDFDDDDDFWDIDDDDDDDDDWDWWWDWDDDDDWWDDDDDDDFDDDDDDDDDWWDMDWWDMDMDDDDDDFDD
DDDDDDDDDDDDMDDMDMDIFDDWDDWFFDDDDDDWWWDDDDDDWDDFWWFFDFDDDDDWWWDDDDDGDWWFDDDDDDDDDMDFWWDDDDDDDDDDDDDD
DDDDDDDDDDMDDDDDDDDDDFWDDWDDDDFDDDDDDFDDDDDDWDDDDDDDDDDFWFDDDDDDDDDDDWWWWFDWWDDDDDFDDDDDFDDDDDDDDDDD
DDDWDDDDDDFDFDDDDDDDWDFDDDWWDWWDWWDDFDDFDFDWWWDDDGDFDDDDWWFMDDDDGDFWDGDDDDDDDDDDDFDDFDDDDDWWDDDDDFWD
DWFDDDDDDDDDWDDDDDDDDDDDDDDDFDDWWFDDDDDDDDDDDDDWFDDDDDMDDDDDDDFDDDFDDDDDDDDDDDDDDDDDIDDDWFDDGDDFDDDD
DDDDIDDDDDDFDDDDDDDDDDDWDDDDDDDWDDDDDWFDDFWDDDDDDWFDDDDWDDDDWDWDDDDDDDDDDDDDDDDDDDDDDFWFDDDDDDFWWDDD
DFDDFWWWDDDDDDDDDDWWDFWWDDDFDDDDWWDWWWFWDWWDDDDDDWWDDDFDDDDDWWWDDDDDDDDDDDDDDDDDDDDDDDWWFDIDDDDDDDWD
DDDDDDDDDDDDDDDDDDDDDDDDDDDDDDWDWWDDDFFWWDDDDDDIDDDDDDDDDWDDDDDWWDDDDDDDFWDDDDWWDDWFDWDIDDDDDDDDWWWD
DDDIFDDDDDDDDDDWFDDWFWWDDDDFDWWWDWWDDWWDDDDDDDIFDDDDDDWWDDDDDDDDDIDDDFWDFDDFDDDDDWWDDDDDDDDDDDDDDDDD
DDDDDDDIDDDDDDDWDFWWWDWWWWFWDWWWFDDDDDDDDWWDDDDDDDWDDDDDDDDDDDDFDDDDDDDDDDDWDDDDMDDDDDFWDDWWDDDDMDID
DDDDGFDDDDDDDDDWWDFDDDDFDDDDDWWDFDDDDDDDDDDDDDDDDWWDDDDWDDDDFDDDDDDDDDDDDDFDDDWDFDDDDFWDDWDDWDDFDDDD
DDDDDDDDDWDDDDDDDDDDDDDDDDDDDWFDDFDDDDFDDDDDDDDDDDFWWFWDWDDDDDDDDDDDDFIDDDDDFWWWDFWWWFDDDWWFDDDGFDDD
DDDDWDDDDWDDDDDDFDDDDDDDDDFDWWWWDDDDDDDDDDDFDWWFWWDDDDDWWDDDDDDGDDDFDDDDDFDIDDDDDWDDDDFDDDDDDDDDWWDD
DDDDDDDDDWWWDDDDDDDDDIFMDDDDDIDDDDDDWDDDWDDWDDDDWWDDDWWWDDDDWWDDDDDWWDDDDDDDDDDDDDDDWWWFDDDFDDDFDDDD
DDDDDFDDDDDDDDDDDDDDDDDDIDDDDDDDDDDFWWWDDFDDDDDFDDDFDDDFDDDDFWDDDDWWWWDDFWWDDDFDDDDFDDDDDDDDDDFDDDDD
DDDDDDDDWDDDDIDDDDDDDDDDDDDDFDIDDDDDFWDDDDDDDDDDDDDDDDDDFWFDFDDDFDDDDDDDDDFDWWDDWWDDDDDDDDDDFDDFDWDD
DDDDDDDWWDDDDDDDFDDDDDFDDDDDIDDDDFDDDWWDDDDDDWDDDFGFDDDDDDFDDDDDDDDDDDDDWWWDDDDWDIFDDDDDDMDFDDDDDDDD
DDDDDDDDDDDDDDDDDFWWDDFDDDDDDWDDDDDIDDDDDDDDDWWDWWFWDDWWWDDDDDDDMDDDDDDDDDDDDDDWDDDFDDDDDFDDDDWFMDFD
DDDDDDDMDDWFDDDDDDWDDFWDFDDFDDDDDDDDDDDDDDDDDDDDDWWWDDDDDDDDDDDDIDDDDDDWDDDFDDFDDDFWWWDDDDDDDWWDDFWD
DDDDDDDDDWWDWWWDFWWDDWWDDDWWWDDDDDDDGDFWWDDFDDWWWDDDDDDDDDDDDFDDDWDFWFFDIFWWDDDDDDDFDDDDWWDDDDFDWWFD
DDDDDFDDDDFWWFFWWDDDDDDDDWDDDFDDDFDDDDWWWDDDDWFFDDDDDDDDDDDDWWDDFDDDDDDDDGDGDDDDDDDDDDDDDDDDWDDDDDDD
DDDDDWWDDDDDDDDDIFDDDDDDDFWDDWDDDDDDDDDDDDDDWWDWWDDDWDDDDDDDDDDDDFDDDDDDDFDFDDDDFWWDDDDDDDDDIDDDDDDD
DDDDDFWFDDDDDDDDGDIDDDDDDFWWWWDDDDFDFDDFFGDDDDDDFDDFWFDDDDDDDDDDDDDWWDIDDDDWDDDDDMIDDDDDDDDFDDDDDIDD
DFDDDWWDFDDWWDDDDDDWWFFDDDDDDDWWDDWWWDDWWDDFDDWDDDDDDDDFWWWDDDDDDFWFWWDFWWDWWDDDWDDDDDDWDWWWDDWWDDDD
DDDDDDDDDDWWDDDDDDWWDFDDDDFIFDDDDDDDDFDDDFDDDDDDDDDDDDDDDFDDMDDDDWWDDDFDDDDDWWDFWWFDIDDDDWDDDDDGFDDD
DFWWFDDWDDWDDWDDDDDFDFDDDDDDWDDFDDDDDWDDDDDDWWDDDDDWDDDDDDDDDDDDDFDDDFWWDDMDDDDDWWFDDDDDDDDDDDDDDFWD
DDDDDDDDDWDWWDFDDDDDFDGFFDDDWWDDFDDDDDDDDFDFFDDDDDWWDFDDDDDDDDDDDDDFFDDDDDDDDDDDDDWDWFWDDDDDDDDDDDWD
DDDDDDDDDWWDDWWFDDDDDDDFDFWWDDDDDDDDDDDDDWWWWDDWWDDDDDDDDDDDDFWDWDDMDDDWWDDDDDDDDDWDDFWWFDDDDDFDWDMD
DDDDMDDDDDDDWWDDMDDDDDDDDDFDDMDDDDFWDDDGDDDFDDFDDDDDDDDDDDDMDDWFWWDDIDDDDDDDDFDDDWWDDDWDDDFDDDDDDDDD
DDFDDDFDDDWWDDDDDDDWFDDDDDWWWDWFDFWWDDDDDDDFDDWDDDDDDDDDDDDDDDDDDDDDDWDDDFDDDDDDDDDDDWWWDDDDDDDDDMFD
DDWDDWWDDDDDDDDDDDDDDDIDDDDDDDWWFFDDDDDDDDWWDDDDDDDDDDFDDDDDDDDWWDDMFDDDFDDDDIFDDDMDWWDFWDDDDDDDDDDD
DWWDFDDDDDDDDDDDDDDDDDDDFDDDDFDWDDDDIDDDDDDDDDFDDDDDDDDDDDWDDDFDDDIDDFWDWDDDDDDDDDDDWDDDDDDFWWDDFWWD
DIDWDDDFDDDDDDDDDDMDFDDDDIDDWWFWDDDMDDDDDDFDDDDDDIDWFDDWWDWDDIDDDGDDDFDDWDDDFDFDDFDDDDDDDDDDDDDDWWFD
DDDGDDWWDDDFDWDDDDDDDDDWWDDDDDDDDDDDDWDDDDDDDDDWDDWWDDDDFFDDDDDDDDWWDDDDDDDDDDWDWWDDDDDDDDDDWWWWDDDD
DDDDGDDDDDDDDWDDIFDDDDDDDDDDDWDDWWDDFWWFWWWDDGDDDGDIDDDDWDDDDDDDDDDWWWDDDDDDFDWWDDDDDDDDDFDDDDDFDDDD
DDDDDIDFWDDDDWDDDDDDDDDDDWWWWWDDDWDDDDFWDDDDDDDDDFDDDDWWWDDDDDDDDIDDDWDIDDDDWDDDDDIDDDFWWWDDDDDDDDDD
DDDDDDDDDDDDWWWFDDDDDFDFDDDWDDDDDDDDDDDWDDGDDDDDFDDDDDIDDDDDDDFDDDDDFWWDDGFDWWDDFDDDFWWFDDDDDWWDDDDD
DDDDDDDDDWDDDDDDWDDIDGDDDDWWDDDDDDDFDDDMDDDDDDDDDIFDDDDDDDDFDDDDDDDMDDDDDDDDDDDDWDDWFWWDDDDMDDDDDDDD
DDDDDDFFDIDDDDDDDDDDWDDDDDDDDDDDDDDDDDDDDDDDDFDDDDFDDDDIDMDWWDDWDDDDDDDDFWFDFWDDDDDWDDDDFDDDDDDDWWDD
DDDDDDWWDDDDIDDDDDDFDDWFDDGDDDDDDWWDFDDDDDDDDDDDDDDDDDDDDDWDDDDDDDDDIDIFWDDDDDDDDWWWWDDDDIDDDDDFDDDD
DDDDDDDDDWWDDDDDDDDDDWWWWFDDDDFDIDDDDDDDDDDDDDDDFFDDDDDDDDDDDDDDDDDDGDFDDDDWWDDGFDDDDDDDDDWWFDDWWWDD
DDFWWWDDDDDFDIDDDDDDDDDDDDDFDDDDDDDMDDDDDFDDDIDFDDDDDDDDDDDFDDDDDFDDDDDDDDFDDDDDFDDDDDDDDDDDDDFDDGDD
DDDDDDDDDDDDDDDDIDDDDDDDDDDDDDDDWWFDDDDDDDDDGDDFDDDDDDFDDDDWDDDDFWDFDDDDDDWDDDWDDDDDIDDDDDDDDDDDDDWD
DDDDDDDDDDDDDDDWDDDDDFDDDWWDDDDDDDDDDDDDDIDDDDDMFDDDDWWDWDDWDIDDDWWWDDDDDWWDDWWFDGDDDDDWWDDDDDDFDWWD
DDDDIDDDDDDDDDFWWFDDDDDDWWDDDFDDDDDWWDDDWFWWDDDDDDDDDWDDDDDWWDDDWDDDDDDDDDDDDDDDDDDDDDDDDDDDDDDWDDDD
DDDDDDDDDFDDDDWWFDDFDDDDDDDFDDDDDFWDDWWDWWDDDDDWWDDDDWDDDDWDDMDDDWFDDDDDWDDDDDWWDDDDDDIDDDDFWDWFDDDD
DDDFWDDDDWWFDDWWDFWWDDDDDDDWWDDDDDDWWDDDDDDDDDDDDDDDDWWDDWWDDDDDFDDDFDDDDDDFDDWDDDDDDDDDDFDWWDDWWFDD
DDDWWDDFDDDDDFWDWDFDDDDDDDFDDDDDDMDDWFDDDDDDDDDWWDDDWWDDDDDDDDDWWDDDWWDDDWFMDWDDDDDDDFIDDDDDDDDDDDDD
DDDDDDDWWDDWDFDDWDDDDDDDDWWFDDWWWDDDDDDDDDDDDDDDDDDDDWWDDDFDDDWDDDFDDDFDDDIFDDDDDDDDDDDDDDDDMFDDDDDD
DDGFDDDDDDWWFFDWWDDDDDDDDDFWFFDDDDDDDDWFWDDDDDWFDDDDDWDDDFWWFDWWFMDDDDWFDDDDDWDDWFDDDDDDDDWDDDDDDDDD
DDFDDDDDDDDIDDDDFDDDDDDDDDDWDDDDDDDDWWWDDDFDDDDDDDDDFWDDDDDDWDDDDDDDDFDDDDIDDDDWWDDMFIDFWWWWDDDDDDDD
DDDDDDDDDDDDDDDDDDDWWDDDDFDDDDDDGDDDFDDDDWWWDDDDDDDDDWWWDWDDDDDGDFDDDDDDDDDDDDDDDDDDWDDDWWDDFDDDDDDD
DWDDDDDWFDDDDDDDDWWFDIDDDDDDDGDDFWWDDDDFDDDDDDDDDDWDDDDFDDDDFFDDDDDFDDDDDDDDDFDDDDDDDDFDWDDDDDDDDDDD
DWWFDDFDDDDWDDDDDWFDDDDDDDDDDDIDWWDFDDDDDDDDDDDDDDWWWDDDDDDDDDDDDDDDDDDDDDDDDFDDDDDDDDDFDDDDDDDDDDDD
DDDIDDDDDDFWWDDDDDDFDDWWFDDDDDDDDDDDDDDDDDDDDDWWDDDDDDDDDDDDFGDDDWWFDDDDDDDFDDDDDDDWWDDDDDDDDDDFDWWD
DDGDWWFDDDDDFDDDDDFDFMDDDMDDDDDDDDDDDFDDMDDDDWDDDDDDDDDDDDDDDDDDDFGDDDDDDDDWDFDDDDDDFWDDDDDDDDFWWWWD
DWDDMDDWWDDDWDDWWWWDDDDDDDDDFDDDDDDDIFFWFWWDWWDDDFDDDDDDDDDDFDDDDDFWWWWDDDDDDDDFWDDDDDDDDDDDWFDDDFWD
DDDDDDIDDFWWWWDIDDDDFWDDDDIDDDFGDDDDDDWWWDDDDDDDDDDDDDDDDDDWWDDDDDDIDDDDDDFDDDDWDDDDDDWWDDDDWWFIDWWD
DDDDFDDDDDDDDDFMDDDDDDDWWWFDDWWFFDDDDDDDIDDDDDDWWDDDDDDIDDFMDDDDDDDFDDDDDDWWDDDDDDIFDDDWWFDDDDFDDDDD
DDDDWDDDDDDDDDDDDDDDWDDDDWWDDWFFDDDDDWFDMDDWFDDDDDDDDDDDWWWDDDDDDDFMFFWWDDDDDDDDDDDDDDDDDDDWFDDFDDDD
DDDDDDDDDDDDDDDDDDWWWWDDFDDDDDFDIDDFWWDDDDFWWWWDDDDWWDDDDDDFFDDDDDMDWDDDDGFDDDDWWWWDDDDDDFWWDWFDDFDD
DDDDDFDDDDDDDDFDDDDDDFWDWFDFWFWDDDDDDDDFDDDDDDWWWFDDDFDDDDDDDDDDDDIDMDDDDIDDDDDWDDDDDDDDDDDIDDFDDWWD
DWWFWWWWDWDDDWWDDDDDDWWFDDFDWDDDDFFDDDDDDWWWDDDDDDDWFDDDWDDDDDDDDDDDMDDDDDDDDDDDDDDDFDDWDDIDDDDDDMDD
DWWDWDWWWWWDWWDDDDDDDDDDDFDDWWDMDWWWDDDWDDDDDDDFDGDDFDDDDDDWDDDDDDDDDDDDDDDFWWDDDFDDDDWWDWFDDDDDDDDD
DDDDFWWDDDFDDDDDDDDFDDDWDDDDDDDFDDDFDDDDGDDDWDDWDDWDDDDDDDDDDMDDDDDDDDDDDDDWDDDDDDDDIDFDFWDDDDDFDDDD
DFDDDDDDDDDDWWWDDDDDDDFIFDDDGDDDDDDDDDDDDDDDDDWWDWFDDFWWWWWFDDDDDFDDFWWDDDDWWFDWDWDDDDDDDWWDDFDWDDDD
DWFDDWWDDDDMDDDDDDDDFDDDDDDDDWDDDDDDDDDDDDDDDDDDDWWWFDDDFDDWDDDDDWWDDDDDDDGDDDDDFDDDDDDDDDDWFDDWDDDD
DDDDGDGDDDDDFFWDDDDDDDDDMDDDWWDDDFDDDFDDDDDDDDDDDDDFWDDWWDDDDDDDDDFDDDDDDDDDDDDDWDDDDDWWWFWWFDDDDDWD
DFDDDDDDDDDDDDWDDWDDDDDDDDDDWWDDDFDDFDDDWDDFDDWWWDDWWDDDFDDDDDDWDFDDDDDDDIFDDDDDDDDDDDFMDDMDDFDDDWDD
DIDDDDFDDDDDDWWDDDDDDDDFDDDDDDDDDDDDDFDDWWWWDDDDDDFDDDDDWDDDDDDDDDDDDDDMDDDDGDDDDWFDDDDDDDDFWWDDDWWD
DDDDDFWWFDDDDFDDDDDDDDDDDDDWDIDFWDDDWWDDDDDDIDWDFDDDWWDWWWDDDDDDDDDDDDDDDDDDDFDFWWDIDMDDDDDDWDWDDDWD
DDDDDDDWWDDDDIDDDDDDFDDDDDFWWFDWWDDDDDDDDFWWDDDDDDDDDFDDDDDDDDDDDDFWFDDDDDDDDWDDDDDDDDDDDWDDDDDFDFDD
DDDDDDDDDDDDDDDDDDDDDDDDDDDDDDDDDDDDDDDDDDDDDDDDDDDDDDDDDDDDDDDDDDDDDDDDDDDDDDDDDDDDDDDDDDDDDDDDDDDD