;Map made by Santella Agustin
;element index
;  D : Diert
;  M : Mountain
;  W : Water

; starting the level:
DDDDDDDDDDDDDDDDDDDDDDDDDDDDDDDDDDDDDDDDDDDDDDDDDDDDDDDDDDDDDDDDDDDDDD
DDFDDDDWDDDDDWWDDDDDDWWWWWWDDDFDDMDDFDDWDDDDDDDDDWDDWDFDDDFWDDFDDFDDWD
DDDDDFDDDDDFDDDDFDDDDDDDDDDWWFDDDDFFDDDDDDMDDDDDWDDFDDDDDDDDIDDIDDDDWD
DDFDDMDFWDDWDFDWWDDWWDDDDDWDDDDDDDDDFDDDFDDDDDDDDDDDDDDDDWWDDDDDDDDDDD
DDDMFDDFWDDIDDDDIDDFDDDDDDDDDDDIDDFDWDWWWDDDDDDDWDDDDDDDFDDDDDFWFDDIFD
DWDFDDDDDDFDFDFIDDDWWWWDMDDIFDDDDDDDWWFDDDDDDDFWWDDDDDDDIDDDDDWDDDDDDD
DWWFDDDDDWWDDDDIDFWDDDDDDDDFDDDDDDFDDDDDMDDIDDDIFDDDDDDDDDDDDDDWWDDDDD
DDDDDDDDDDDDDFDFDDWDDDDFDDIFDWWWFDDDDFDDDDDDWDFDDDDDDDDDDDDDFWWWFDDDDD
DDDDDFDDDDDDDDDDDDDDDDWWDDDDDWDDDGFWWWFDDIDWWDWDDDDFDDDDDDFDDDDDDDDDDD
DDDWDDDDFDFWWDWDDDDFDWDDDDDDFDDWFDDDFDDWWDDDDDDDDDDDDDDDDDDDDDDDWWDDDD
DDWWDFDDGDDDDDDDDDDDDDDWWDDDDFDDDDDDFDDWWDDDIDDDDFDDDFDDDDFFDDDDDDDDDD
DDDIDDDDDDDDDFFDDWDFWDDDWWFDFDDDDDDFDDDDDDFDDFGDWWDDDWFDDDWWWFWWDDDDDD
DDDDDDDDDDFWWWDDDDIDWWDDDDDDDDWDDDDDFDDDDWWWDDDDDIDDDWWDDGDDDWDDDDIDDD
DDDFFDFDDDDDDDDDDDDDDIDDDDDDDWWDDDDDDDDDDDDDDDDDDDDDDDWDDDDDWWDDDDFWWD
DDFWWDDDIDDIDWFDDDFWWDDDWDDFDDDDDFDDDFFDDWWDDDWWFFWFDFWWDDDDDFFDDDDDDD
DDDFDDDDDDFDWWDWDDDDDDDFDDDGFDDDIDDFWWWDDDDFDDDGDWWDWFWDDDDDWWWFDDDDDD
DDDDDDDFDDDDDDDDDDDDDDDDDFDDDDDDDDDDDDDDDDDWWDDFDDDWWWDDDDDDDWDDDDDFDD
DDWDDWWWDDDDDDDDDDDIDDMDFWDIDDDDDDDWDDDDDDWDDDDDFDDDDWWDFDDDFWDDDDDDDD
DDDDDDDWWDDDWFDMDDDDDDDWDDDDFWDDDIDWFDDWWDWDFDFDDDFWDFDDDDDDWWDWDDDDDD
DDDGFDIDDDDFWWDDDDDDDDDWWDFDDWWDDDFWFDDWDDDDWWWFDDWWWDDDDDDDGFDDDDFDDD
DWWFDDDDDDDDDDDDFFDWDDDWWWWDDDWDDDFDDWDDDDDDDDDWWDDDFDDFWWDDIDDDDWWFDD
DDDDDDDDDDDDDWDWWWFDDIDFDDDFDDWFDDDDDDDDWWDDDDDDDDWDWWWDWDDDGDDDDDDDDD
DDDDFDDDDGDDFWDDDDDFDDDDFDWWWDWDFDDDDIDWWDDDDDDDDFWDFDDDDDDDDDDWWWDDDD
DDIDWDDWDDDIFWWWDDFDDDDFDFDDDWFFDDDDDDDGDIFDDDDDDDWWWWDWDDDDDDDDDDWWWD
DDDWWFFWWDDDDDDDDDDDDWDDDDIDMDDDDDDDFDDDDDDDWWDDDDDDFWWWWFDDFDDWFDDDDD
DDDWWWDWDDDDDFDDDDDDDWWDDDDDDDDDDDDDDDDDDDMDDDDDDDDDDDDDWWFDDDWWWDDWDD
DDFDDFDDDDDIDDDWWWDFDDDFDDFDDMDDFDDDDGDDFDDWWWDDFWFDGFIDDDDDDDDDDWDWWD
DDDDDWDDDDIDWDDDDDDDDGDDDFWDDDWWWFDDDDDDDDFDDDDFDDDDDDDDDDFDDDDDDDDDDD
DDDDDWWDDDDFDDDMDDDDDFDDDWWDDDDDDWWDDDFDDMDDIDWWDDDWFDDDDDWWFDDFDDFWDD
DDFFWDDDFIDDDDWDDWWDDWWDDDDDDDDDDWDDDIDFDDDDDDDDDDWWDDDDDDDDDFFDDWDDFD
DDDDFDDDDDDFDDDDWWDMDDDDDDDFDDWWDDDDFDDDDDDDDDWWDDDDDFDDDDDDDWWFWDDDDD
DDDDDDDMDDDDDDDDDDDDDDDDDDDDDDDDDDDDDDDDDDDDDWWDDDDDDWWDWDDDDWDWDDDDDD
DDDDDWDDDWDDDDDDDDDDDDDDDDDWWWDFDDDDDDDDDDDDDIFDDMDDDDDWWDDDDDWWWDDFDD
DDDDDDDFDWWFDDDDDDDDDDDDDDDDDFDDDDDDDDDFDDDDDDDDDDDDDDDDDDDDDDDFDDDDDD
DDDDDDWWDFDDDDDDDFDWWFDDDDDDDDDDDFDDFDWWDWDDDWDDDDDDFDDWWDDFDDDDDDDDDD
DWWWDDDWDDIDWDDDDWDDDDDDDWWDWDDWDDDDWDDWDWDDFWDDDDDDWWDDDDDDDDDWWFDWDD
DFFDDDDWDDFWWWWDDDDFDDFDDWWDDDWWDFWDWDDDDDDFDWWDDDDDDDDDDDDFDIDWWWDWWD
DWFDDDFWDDDWDFWWDDWWWDDDDDDIFDDDDWWWWDDDDDWWFDDDDDDDDDDDFDDDDDDDDDDDDD
DWWDDDDDDDWWDDDDDDDDDWFDDDDDDDDDDDDDDGDDFDWDDDDWDDDDIDDDDDDDWDDDDWWFDD
DDDDDDDDDDDDDDDDDDDDDDDDDDDDDDDDDDDDDDDDDDDDDDDDDDDDDDDDDDDDDDDDDDDDDD