;Map made by Santella Agustin
;element index
;  D : Diert
;  M : Mountain
;  W : Water

; starting the level:
DDDDDDDDDDDDDDDDDDDDDDDDDDDDDDDDDDDDDDDDDDDDDDDDDDDDDDDDDDDDDDDDDDDDDDDDDDDDDDDDDDDDDDDDDDDDDDDDDDDD
DDWFDDDDWWDDFDDDWDDDWDDDDDDWWDDDDDDDWWDDDDDDFDFDMDDDDDWWDDDDDDDDDDDDDDDDFDDDDDDDDDDDIDDDDDDDFDDDDDDD
DDDDDWDDDDDDDDDDWWDFWFGFDDDDDDDWWDDDDDDFDDDDDDDDFDDDDDDWFDDDDDDDWWDDDDDDWDDDDWWFDDDDDDGDDIDFDDDDDDFD
DDDDFWWDDDDDDDDDDDDWWDDDDWDDDDGFDDDDMDDDDDDDDDDWWDFDDDDDDDDDDFWWDDDDDDDFWFDDDDDIFDFDFFDDDMDDDDDDDFID
DDDFWWDDDDDDDFWFDDDDDDFDDWFDGDFFWWDDDWDDDDDDDDDDDFDDDDDDDWWDDDDDDDDDDDDDDDDDDDDDDDDDWWDDDDDDDDDDDDGD
DWDDDDWDDFDDDDDDDWWDDDDDFDDDDFDDDDDDWWWDDDWDDDDDDDFDDDDDDDDDDDDWDDDDDDDDDDDDDDDMDDDDDDDDDWDDDDWDDDDD
DWWDDDWWDDDDDDDDDDFDFDDDDIFDDDDDDDDDDFDDDDDFWFIDDDWFDDDDIFDDDDDWFDDDDWWDDDGFDDDDDWDDDDDDFWDMDWWDDDDD
DDDDDDDDDFDDDDGFDDDDDDDDIFDDDIDDDDDDDDFWWDFWWWFDWDWWDDDDFDDDDDDDDWWWDDDFFDDDDDDDDDDDDDGDDDDDDDFDDDDD
DDDDDFDWFDDDDDDGDDDDMDDWDDWDDDDDDDDDDDWWDDFDDDDFDFDDDWWDDDDDDDFDDDDDDDDWWDDDDDDDDDDDDDDDDDDDDDDDDDWD
DDDWWWDWDDDDIDDDFWWDDDDWFDWWDDDDDDFDIDDDDDWDIDWWDDDDDDDFDDDDDWWFDDDDDIDDDDDDDDDDDDDDDDDDWDDDDDDDDDWD
DDDDWDDDDMDDDIDDFWDDFWDDFDFWWDDDDDWDDDDDDDWWFDDDWDDDDDDWWWWDWWDDDDDDDDDDWDWWDDDDDDDDDDDDWWDDDDWDDDFD
DDDWWDIDDDDMDDFDDWWFDWDDDDDDFDDMDDWFDDDDDDDDDDDWWDDDDDDDDDDDDDDFDDDDDDIDDDDDDFWDDDDDDDDDDDDIDDDDDDWD
DFDDDDFDDDDDDDDDDDDDWWDDDFWWWWDDDDWWDDDDDDDDDFDDDDDDDDDDDDDDDIDDDDDDDDDDDDDDFDWWDDDWDDDWDDDDDDDDWDDD
DWWDDDDDDDFDDDDDIFDDDDDWWDDDDDDDDWFDDDDDDMDDDDDDDDDFDFDDWWWDFFDDDDWDDDDFDDDDDDWWWDDDDDDDDDMDIDWDDDDD
DDFWWWDDDDDDDDDDDIDDDFDDFWWWDFWDDWWFDDDDDDDDDDDDDDDDFWDDDDDDWWWWDDDDDDDFDDDDDDDDFDDFWDDDDDDDDDWWFDDD
DDDFWWDDDDDDDDDDDIDFDDDDWDDDDDWWDDDWDDDDDDDDFDDDDDWFDIFDDDDDDDDDDDDWWDFWWFDFDFDDDDDDWWDDDDDIDDDDDDDD
DDFDDDMDDDDDDDFDDIDDFDDDWFDDDDDDDDDWDDDDDDDDWWDDDDDDDDFIFDDFDDDIFDDDWWDDDWDDMDDDDWFDDDDDDWDDFDFDDDDD
DWWWDDDDDFDDDDDDDDWFDDDDDDDDDWDDDWFWWWDDDDWFDDWFDDDDDFWFDWWWDDDDDDDDDDDDDDDDDDDWFDDDDDDFFDDDWWWDFDDD
DDDDDDDDDIFDDDDDDWWWFDDMDDDDWDWWDDIDDDDDDDWWDWWWDDWWDDWWDDWWFDDDDDDDDDWWDDWDDDDWWDDDDDDDMFDDDDDDDFFD
DFDIDDDDDDDDDDWDDDDDDDDIFDDFDWDDDIDDDDDDDDDDDDDDIDDDDDDDDDFDDFWWDFDDDDFDDFDDDWDDFFDDFDDDDDDDDDWWWWWD
DDDDDDDDDDFWWDDFDDDDDDDDDDFDFWWDDDDDDDDWDDDDDWWWDDDDFDDDDDWWDDDDDDDDDDDFWDDDDWWDWWDFDDFWWDDDWWDDDFDD
DDDWWFDDDDDDDWDDDDDDDDFDDDDDDDDDDWWDDDDIDWDWDDFDDIDDDDDDDDDDFWDDDDDDDDFDDDDMDDDDDDDDDGDDWDDDDIDDFDDD
DDDDDDDDDFWDDWDDDDDDDDDDDDDDDDDDDDDDDDMDDDFDDDDDDDDDDDDDWWDWWWDDDDFDDDWWDDDDDDDDDDWWDDDDDDDDDFWWDDDD
DDFDFDDDDWDDDWWDDWWFDDDDWWWDFIDDDDDWDDDWWDDFDFDDDDDDWDWWFDDDDDWDDDDDDDWDDDFDDWWDWFWDDMDDFDDDDFDDDDDD
DWWDDDDDIDDDDDWDWWWDDDDDDDDDDDDDDDWWDDDDDDDDDWDWDDDDWWWDDDDDDDMIFDDDDWWFDDWWFDDDDDDWDDDDDDWWDDDFDDDD
DDDDDDDDDDDDWDDDDDDDDDDDDDDDDDDDDFDDWWDDDDDDDDDWDDFDIFDDDDIDDDGDDDDDDDDWDDDFDDDDDDFDDWWWDWWWWDDDDWWD
DDFDDDDFDDDFWWDDDDDDDDWDDFDDDDDDDWWDMFDDDWWDDDDWDIDDDFDDDDDDDDFDDDFDDDDWWDDWDDDFDDDDDDDIDDDDWDDDWWDD
DDDDDWWWWDDDDDDDDDMDDDDDDDMIDDDDDDDDDDFDFDDFDDDDDDDDDDDDDDWDDDDDDDWDWFDDDDDIDDDIFDDDDDDDDDDDWWDDDDDD
DDDDDFDDWWDDDDDDDDFWDDDDDDFDMDDDDWWFDDDDDDWDDDDDDDDDDDDDDDDDDDDDFFWWWWDDDDDDDDDDFDDDDDDDDDDDFWWDDDDD
DDDDDDDDDDDDDDDDDFDWWDDDDDDDDFWWDWWDDDDDDDDIDDDDWFDDDFDDDDFDDDDDWDDDDDDDDDDWDDDFWDDDWFDDDDDDFDDDDDDD
DDDDDDDDDDDDDDDDDDFDDDWWDDDFDDDDDDDDDFWWFDFFWWWFDDDDDDFFDDDFDDGDDDDDDDWDFDDWDDWWWWDDWDWWDDDDDDDDDDDD
DDDDFDDDDDDDDWWWDDWDDDFWDDDDDDDMDDDDDWWDDFDDWDDDDDDDDDWWDWDDDDDDDFDDWWDDDDDWWWWWDDDDWWDDDWWDDDDDDGDD
DDDWWWDDDDDDDDDDFDMMDDDDDDDDWDDDDFDWDDFDDDDFWWDWFDDFDDDDFDDDDDDDDWWDWFWWDDDDDDDDDDDDWWWFDWWDDWWDDDDD
DDDDFDDDWFDDDDDDDDDDDDDDDDDDWFDDDWWWDDWWDFDDDIFDDDDDDWDDDDDDFDDFDDDFWDWWDWDDDDWWFDDDDDDDDDDDFDDDDWDD
DDDDDDDDWDIFDDDDDDDDDDDDDDDFDDDGDDDDDWDDDWWWFDDDDDDDWWWDFDDDDDFWWDDWDDDMDDDDDDWDDDDIDDWWFDDDDFDDWDDD
DDDDDDDDWDDDDDDDDDDDDDFDDDDFDDDDWDDDDDDDDDDDDDDDDDFDMDDWWDDDDDDDDDWFWWWDDDGDDWWDDDDDDFWWWDDDDGDWFDGD
DDFWWFDDDDDDDMDDDDIDDDDDDDDDFDDWWDDDDDDDDMDFDDWDDFWWDDDDDDIFDDDDDDDDDDFDDDDDDDDDDFDDDDDDDIDIFDDDDIFD
DDDIDWWDDDDWFDDMDDDDDDDFDFDDDDDDDWWWDDDDDDDDDDDDWDDDDFDDDDDWDWFFWFDDDDDDDWDDDDWFFDDDDDMDDDDDDDDDDDDD
DDDFDDFWFDDWWDDDDIDDDWWWFDDDFWDDDWDDDDDIFDDDDDDDWWDDFDIDDDDDDWWDDDIDWWFDDDDDFDDDDDDDDDDDDDDDDDWWDDDD
DDDWWFDWWDDDWWDDDDDDIDDWWDDFFWWFWWFDDDDDDDDDWWDDDDDDDDDDWFFDIFDDDDDDDDDDDDDDWWDDDDDDDDDDDMDWDDFDDDDD
DDDDDDDDMDDDDDFDDDDWDDWWDDDWWDFDDDDDDGDWFDDDWWWDFDDDDDDWDWWWFDWWFWWDDDDWFWDDIDGDDDDWWDDDDDFWFDDDDDDD
DDFDDDDDDDDDDIDDFDDWWDDDWDDIDDDDDDDWDDDDFDDDIDDDWWDDDDDFWDWDFWDDDWDDDDDDDDDDDDDDWDFWDDDDDFWDDDDDWWFD
DWWDIDDDDDDDDDDIFDDWFDDWWDDDDDDFGDDWWWDDDDDDDDDWDDGDDWDDDWWFFDDDDWWWDIDDWDIDMDDDWWFDDDDFWWDDDGDDDDDD
DDDIFWDDWWDDGDDDDWWDDDDDDDDFDDDDDFFDDDDDDDDDDDWWDDDDWWWDWWDDDDDDDDDDDDDWWWDDDWWDWDDDWWWDDFDDDDDDDDGD
DDWDDWDDFWWDDFDDDDDDDWFDDDWWFWDDDDDDDDDDDDDDDDDGDDDDDDDFWWDDWWWWWFDDDDDDWDDDDDDDWWFDDFDDDFDFFDDDDDDD
DDWFDWDDDWDDDWWDDDDDDDDDDWDFDWFDWFDDDDDDDDDDDDDDDMDWWFDWWDMDDDDDDDDDDDDWWDDDDDDDDDDDDIFDDDDWWWDDFWDD
DWWDDWWDWWFDDDDDDDWWFDDDFWWWDDDWWWFDDDWDDDDWDWDDDDFDDDDDFDDDDDDDDDDDWDWWDDDDDDDWWDDDDDDDWDIDDIDDWDDD
DDDDDDDDFDDDDDDDDDDDDWWDWDDDDDDDDDDDDDDMDDWWWWDDDDDDFWDDIFDDIFDDDDWDDDWDDDDDDDDDDDDDDWWDWWDWWDFDDDDD
DDDWDDDDWWWDDDDDDDDDDFIDWDDIDDDDDDDDDDDDDFGFDDDDWDDDFDDDDDDDDDDFWWWDDFWFDDDDDWWDDDDDDDWWFDDWFDWWWDDD
DDWWDDDDDDDDDDGDDDDFDFDDWDDDDDDDFDDDDMDDWWDDIDFDWWFWDDDDGFFDDDWDDFDDDDWWDDDFDDDDDDIDDDFMDMDWDDDDDDFD
DDDDDDWFDWWDDWFDDFDDDDIDDDDDDDFDDDDDDDDDDFDDMDWWWDDWDDWDDDDDDDWFDDFDDDDDDDDDDDDDDDDDDDWDDDDWWDDDDDWD
DDDDDDDDDDDDDWDDWWWFDDDGDDDDDWWWDDWDDWFDDDDDDDDDDDDDDDWWDGFDDDDDDDDDDFDDFDDDWWDDDFDDDDWWDDFGDDFDDDWD
DDMFDDDDWWWDWWDWDIDFDFDDDDDDDDWFDWWDWWFDDDDDDDDDDDDMDDDDFDFDDDDDDDDDWWDIDDDDDDDDDDDDDDDDDDDDDFWDGFDD
DDDWWDDDIDDDDFWDDDWWFDDDDDDDDDDDDDDDDDDDDDFWDDDWWDDDDDDDDDDDDDDDDDDWFDIFDDDDDDDWWDFDDDDDFDDDDDWWFDDD
DDFDDDDFDMDWWDWWDDWDDDWDDFDDDDDDDWWDDDWWDWDDDDDDWWDDWWDDDDDDDDDDDDFDIDDDDDDDDDFWFDDFDDDDDDDDFDDIFDDD
DDDIFDDWWDWDDFDDDWWDFWWDDDIDDWWDMDDDDFDDDWWDDDDDDDDDFDDFDDWWWDIDMFDDDDDDDDDDDDDDDDDWWDWDDDDDDFDDFDDD
DDDDDDDDDDWWDDDDDDDDDDDDDDDWWFDDDDDDDDDDDDDDDDDDDDFWWDWWWDDDDDDDDDDWWWWDDDDDDDDDDDFDDDDDDWWDFDDDDFDD
DDDDDDDDDDWWDFDDDDFDDDDDDDDDDDDDWWFDDDDDWFDDDDDDDFWDWWDDFDDDDDDDDDDDDDDDDDDDDDDDDDDIDDDDIDDDDDDDDDDD
DDDDDIFDDDDDDDFDIFDDDDDDDDDDDDDDDMDDIDWWWDDDDDDDDWWWDDDDDDWWDDDDFDDDFDDDDFDDDDDDFDDDDDWWDDDDDDDIDDDD
DDDDDDDWDDDDDDDDDWDFWWDDDDFDDDDDDDDDFMDDDDDDDDDDDDFWFDFMDWWWDFDDDDDWWWDDDDFWDDDDDDDIDDDFDDDMDDDDDDDD
DDDDDDDDDDDMDDWDDMDDDDDDDDDDDDDDDDDDDDDDDDDDDDDIDDDDDFIDDDDFDWDDWWDDDDDDDDDDDDDDDDDDDDDDDDDDFDDDDDWD
DDDDDDDDDDDDDWWDDDIDDDDWDDDWWFDFDDDDDDDDDDDWWDDDDDDDDDDFWFWWDDDDDDDDDDFDDDIDDFFDDDWWWDDDDDDDDDDIDDDD
DDDIFDDDDDDDDDDDWDDDDDFDDDDFWWWWWDDDDDDDDDDDDDDFDDDDWWDDWWDDDDDDDDDDDWWDDIDDDWWFWWDDDDDDFWDDDDWFDDDD
DFDDDDDDDDDDDDDWWDDDDDDDIDDDFDFWWDDWDDDWDWFDWDWWDMDWFWWDFDDDDDDDDDDFDDDDFDDDDDIDWWDFDDDDDWWDWDWWWWDD
DDDDDWFDDWWDWWDDDMDDDDDDIDWDMDDDDDFWWDDWWDDDDDWDGDDDDDDDDDWWDDDDDDWWFDDDDDWDDWDFDDDDDDDDFDDFDFDDWDWD
DWFDDMDFDDDDDDDDDDDDDDDDDDDDDDDDDDWWFDDDDWWDFWWFDDDFDDDDDDDDDDDDDDDDDDDDDDDDDWWWDDDDDDWFDDDDDDDDDDDD
DDDDDDDFDDDDDWFDDDDDFDDDDDDDDDDGDDDDDDIDDDDDFFDDDDDWWDDDIDDDWWDDDDDDDDDGFDDDDDWWFDDWDDDDDDDDDDDDDDDD
DDDDDDDWDFDDFWWDDDDDDDDWDDDDDDDDWDDWFDDDDDDDWWDDDDDDDDDDDDDDDDDDWWFDDDDDDDDDWWWDDDWWDGDDDDDDFDDDDDDD
DDFDDDWDDDDDDFDDWWWFDDDWWDDDMDDWWDDWDFDDDDDDDDDDDFDDDDIDDDWFDFDWWDDDWDWDDDDDDDWWFFDDFDWDDDDDDDDDDDDD
DDWWDDWWDDFWFWDWDDDWWFFDDDDDDDDIDFWDDDDDDDFDDDDFFWWWWWFDDDDDWWWWDDDDWWWDDDDDDDDWDDIDWWWFDDDDDDDDDDMD
DDFDDWWDWWDDDWWDWDDDDWWDDDDDDDDDDDFWDFDDWWWDDDFDDDDDDDDDDDDDDFDDDDDDDDDDFDIFWWDDDDDFDDDDDDDDMIFDDDGD
DDDDDDDDDWDDDDDWWDDDDDDDDDDDGDDDDDDWWDDDDWDDDDDGDDDDDDDDDFWWDMDDDDDDDDDDGDDDDDDDDDDDDDFWWDDFDDDDDDDD
DDDDDFDDWWDDFDDDDDWDDDDDDDDDDDDDIDDDDDDDDWDDDDDDDDWWDDDDDWFDDDWDDDDDDDDFDDDFDDDFDDDDDDDDDDDDDDDDFDDD
DDDDWWWDWFDDDDDDDFWDIDDDDDDDDDDDDWDDDDDDFDDWDDDDDDDDDDWFWWFDDWFDDDDDDDDDDDWDDFDWDDDGDFDDDDDDDFDDIDFD
DDDDDGDDDDDWDDWDDFWDDDDDDDWDDDDDDWWDDDDDDDDWWFDFWDDDFDDDDFDDDWWDDDDDFIDDDWFDDWWWDDDDDWDFDDDDDDDDDDID
DDDDDDDDFDDDDDDDDDWDDDDDDDDDDDFMDFDDDDWWWWWDDDDDIDDDDDDDDDFDDDDDDMDDDDDFDWWDDDDDFDDFFDDWWDDWWWWWDDDD
DDDDDMDDWDDDDDDDDDDDDDDDDDDDDDDDDDDFDDDDDWFDDDDDDDDDDDDDWWWDDDDDDDDDDDDWWFDDDFWDDDDDDDDDDDDDDDDDDDDD
DDDDDDDDIDDDDDDDDDDFWWDDDDDDFWWDDDDWWDDDDDDDDWFDDWWDFDDWDWDDDDDDDDDFDDDFWDDDDWWDDDDDDDDDDDDFDDDDFWWD
DDFGDDDDFDDDDDDDFWWDDDDDDDDDFWDDDFDDDDDDDFDDDWDWWDDDDDDFWWFIFDDDDDDWFDDWWDWWDWDMDDDDDDDDDDDDDDDDDDDD
DDDDDDDDDDDDDDDDDDDDDDDDDDDDDDDDDDDDDDDDDDDDDDDDDDDDDDDDDDDDDDDDDDDDDDDDDDDDDDDDDDDDDDDDDDDDDDDDDDDD