;Map made by Santella Agustin
;element index
;  D : Diert
;  M : Mountain
;  W : Water

; starting the level:
DDDDDDDDDDDDDDDDDDDDDDDDDDDDDDDDDDDDDDDDDDDDDDDDDDDDDDDDDDDDDDDDDDDDDDDDDDDDDDDDDDDDDDDDDDDDDDDDDDDD
DDDDDWWFWFDDDDDDDDDDFDDDWWWDDMDDWWWDDDDDMFWDDDDMFDDDDDGDWWWDDDDWWDDDDDFWFDWDDDFDDWWDWWDDDWDWFDDFDDDD
DDDDDGDDDDDDFDDDFDDDDDDDDDDDIDWWDDDDDDDDDDDDDDDFDDDDDDDWDDDDDDFDDDDMDWDWWWWDDDDDDDWWFDDDDDDDDDDWWDWD
DFDDDDDDDDDDDFDDDDWWFWWDDDDDDDGFDDIFDDDDDDFDDDDDDDDDDFWWFDDFDDDDDDDDDDDFWWFDDDDDDDDWFDDDDFDDDDDWWWWD
DDDDDDDDDDFDDDDDDDDDGDDWDWDWDDDFDDDDDDDIDDWDDDDFWWWDFDDFWWFWDDWWDDFDDDDDIFDDDIDDDDDWDDDDDDDWFDDWWDDD
DFDDDDDDDDDDDDDDDDDDDDDDDDDDDMDWWWDIDDDFDDDDDDDDFDWFWWFDDWFWDDDDDDWWDFDDFDDDDDDDWWDDDWWDDDDDFDDDFDDD
DWDDDDWWFDDDDDDDDDDWWDDDDDDIDDDDDDDDDDDDDDDDDDDDMFWWFDDDDDDDDDDDDDDFDDDDDDDDDDWDDDDDDDDFDDDDWWWDWWDD
DWWDFDDDDGFDDGFWWDDDDDDIDFDDDDDDDDFDDFDDDDDMFDDDDDFDDDDDFDDDFWWDDDDWWDDWWWDDDWWDWDDDDDDDDDDDDDDDIFDD
DFDDIDDDDFDDDDDDDDDDWWDFWWDDDWDDDMDDDDDWWDWDDDDWDDDDIDDDDDDDDDDDDWWDDDDDDDDDDDWDWWDDDFDDDDDDDDDDDDDD
DDDDDWDDDWWDDDDDDDDDWWWDDDDDDIDDDFWWWDWWWDDDFDDDDWDDDDDDDDDDDDDDDWWDMDDDDDDWDDWWDDDDDWDDDIDWFDWDDDDD
DWWDDDDDMDDDDDDIDDDDDDDDDDDDDFWWDDDDIDDDDDDDFDWFDDDDDDDDDIDDDDDDDDDFDDDDDWWWDDDWDDDDDWWDDDDWWDWWWFDD
DDDDDDDDDDDDDDDDDDDDDDDDDDDDDDDDDDDDDDDDDDFWWDWWWFDDWDDDDDDDWDDFWDFDDDDDDMDDDDFDDDDDDFWWDDDDMDDDDDDD
DFWWDDDFDDDDFWDWDDWWDWWDDDDDFDDDDDWWFDDDDDDDDDDDWWWWWDDDDDDWWWDFWDDDDDDFDDDDDDDDDWWDWWDDDDDFDIFDDDDD
DDDDDDDDDDDDDDDIDWWFFDDDDDDDDDDDDFWWDDDDDDDDDGDDDDDDDDDDDDDDDDFDWDFDDDDWDDDDDDDDDDDDFWWDDDDDDDDDDFWD
DDDDDWWDDDDDDDIFDDWWWFIDDDDDDDFDDDDDFWDIDDDDWDMDDDDDDDDDDDDDDFDDWWDDDFDWWDFWWFDDDDDDDDDDDDDDDDWWFDDD
DDDDDDFFWWDDDDDMDDFWWDDDDIFDDDDDDIDFWDDDDFDDWFDDWWDDDDDDDDDDFGFFDWDDFWWWDWWDWWDDDWFDDDDDDDDDDDDDDDDD
DDDDDDDDDMDDDDDFWDDGDDDDDFDDWWFDDFDDDDDDWWDDDDDDWWWWWDDDDDDDWDWWFDDDWWDDWFFWWWWWFDDDFDDDDDDFDDDDDDMD
DDDDDDDDDDDDDDFWWWDDDDDDDDDWWFDDDDDDDDDFDDDDGDMDDDDDDDDDDDIDDDWWDFFDDDFWWDDDDDDDDDMDDDDDDDDDDDDDDDDD
DDDDDDDFWDDFDDDDDDDDDDDDDDDFDDDFDIFFDDDDDWDWDDDWWDDDFWDDFWDDDDDDDWWDDDDDDDDDDDDDDDMDDWWWWWFDDDDDDDDD
DDDDWDDWWDDDDWDDDDDDDDDFFDFDFDWWDDDWDDDDDDFDDDDDDDDDDDDFWWFDDDDDDDDDDDDDWDDDDDDDGDDDDDDDWWDDWWDMDDWD
DWWDWFDDDDDDWWDDDDDDDDDWWFDDWDDWWWDDDDDDDDDFDDDDDDDDDDDDDDWWDDDDDDDDDDDWWDDDDDWFDDDDFWWFDDDDDDDDWWWD
DFWDWWWDWWDWWDDDDDDDDDDDWDWDWWDDDDDDDDFDDDDIFDDDDDDDDGDMFDDDDDDDDDWWFDDDDWFDDDWWWDDDDDDDDDDDDDWDDFWD
DFDDDFDDFDDDDDFDDDDDDMDWWDWWDWDDDDFDDDDDDDDFWWDWDWWDDDDDDDDWDIDDFWWDDDDFDDDDDFDDDDDDDDDDDDDDFWWWFDDD
DFDDFWDWWFDDDDDDDDDDDDDDDDDFWWDDDDDDDDDFDDDDDDDWWWWWDDDDDWDDFDDDDDDFDDFDDDDDDDFDDDDDDDDDDDDDDDDDDDDD
DWWDDDDDDDDDWDDDDDDDDDDDWDDDDDDDDDDDDDWWDDDDDDDDDDDDDDDDDWWDWDDDDIDDDDDDDDDDDDDDDMDDDDDDDDDDWFWWWDDD
DDFDDDFDDDDWWWDDDDDGDDFWFDDDDDDDDDDWWWDFFDDDFDFDDDDDWDDFWWDDWWWDDDDDWDDDDDDDDFDDDDWWWDDDDDDDWWDDDGDD
DDDDDWWDWDDDDDDDFDWDDDDWWFFDDDDWDFDDGDDWWFFDDDDFDDDDDDWDDDDDDIFDFDDWDDDDDDDDDDDDDDDFDDDDDDDDDDDDDIDD
DDDDDDDWWDDDDDDDDDDDDDDDDDDDDDDWFWWDDDWWDWDDFDWWDDDFDWWDDDFWDDDDWWDDDDDWWFDDWWWDGDDFDDDDDDDDDWWFDDDD
DDDDDDDWDFDDDDDFDDDDDDDDDDDFDDDDDDDDDDDDDMFDDDFDDDFWDWWFDIDDDDDWFWDDDDDDDDDDDDDDDDDDFIDDDDWDDDDDDDDD
DWDDGFDWWWFDDDWWFDDDDDDDDDDDDDMDDDDDDWWFDDDDIFWWFDDDDDDDGDDDDWDWWWWDDDFDDDDDDWDDFDDDMDDDDDDDDDDDDDFD
DWWFIDDDDWWWDDDWWDDDDDDFDDDDIDDDDGDDIDDDDDDDDDFDDDDDWDDDDWDWDWWFDDDFMDDDDDDDDIDDDDFDDIDDDDDDDDDDDDDD
DDDIDIDFDDDDDDMFDDDDDDDDDDWWDDDDDDWWDDDDDWWDDDDDDDDDDDGDDDFDDDDFDGDDDDDWDDDDIDFDDDDDDDDDDDWDFDDDFDDD
DDDDDDDDDDDDDDDDDDDDDDDDWDDDDFDDDDDDDDDDDDDDDDDDDDDDDDDWWFGDDDDWWDDDFDFWWFWFDDWDDFDDDDDDDDWWWDWDDDDD
DDDFWDDDDDDDFDGDDDDDDDDWWDIDWWFDDDDDDDMDFDDDDDDWWDDDDDDDFDDDDDWDDDDWDDDFWWWFDFDDWWDDDDDDDDDDDDMDFWWD
DDDWWWFDDDDDDDDDDDDDDDFDFDDDDDDDDDDDDDFWWDDDDDDWWDDDIFDDDDDWFDWWFDWWDDDFDDDDDDDWWDDDDFDDDDDDDDGFFDDD
DIDDDDDDDDWWFDDIDDMDDDWDDDDDDDFDDDDDDDDFDDDFDDWWWDDDDDFDFMDWWWWDDWDDDDDDDDDDDDDDDDDDDWFDDDGDDFDDDDDD
DDDDWDDDDWDDDDDDDDDDDWWWFMDDDDDDDDDDDDWFDWWWWDDDDFDDDDWDDDDWWDDDDFDDDDWWDDDDDDDDDDDDWWFDFDDDDDDDDDDD
DDDWWDDDDWWFFDWDDDDDWWDDDDDDDDFDDDDDDWDDDIDDDDDDDDDDDDWWDDDDDWWDDDDDDDDDDDDDDDWWDWWDDFDDDMDDDDFIDDDD
DDDFDDWWDIFWWDWFWDDDDDDDDDDDDDWDDDDDDDDDDDFWWWDDDDDDWWWDDDDDDWWDMDDDDWDDDIFDDFWDDDDDDDDDDDDDDDWFDDDD
DDDWWDDWDDDMDDDDDDIDDDDWDDFDDDWDDDDDDDDDDDDDWWDDDDDFDDGDDIFDDDDDDDDGDDDDIDFDDDDDWWDDDDDDWWDDDDDDDDDD
DFGDDFWWWDDDDIDDDIDDDWDDDDDDWDDDFDMDDDFDDGDDDDGFDDDDDDDFDDDDGDMFDWWDDDDDDIDFDDDDDDDDDDDDDDWWDDDFWDDD
DDDFDDDDDDDFDDDDDFDDDDDDDDDFDDDWWDDDDDDIDDWWDDDDIDDDDDDDDFDDDDDWDDWWDDDDDDDDIFFWDDFIFFDDDGDDDDFDDDDD
DFWWDDFDDDDDDFDIDDDDDDFDWWDDDDDDDDDDDDDFDDDFDDDDDDDDDMDDDWFDDDDWWDDDDDIDDDDDDDDWDFDDDDDIDDDDDDDDFDDD
DDDDDDDDWWWDWWDDDDDDFFWWDDDDDDDDWFWDIDWWDFDDDDDDDWWDDDDDDWWDDWWDDDWWDDDDDDDDDWWWWWFDDDDFWDFFDDDDDDFD
DDDDDDDDDDDDDDDDDIDDWWFDDDWWWWDFWDWDDWDFDDDFDDWWFDDWDFWWFDWWDDDDDDDDDFDDDDMDDDDDMDDDDDDFDDDDDDDWDDDD
DDDDDDFWDDDDDDDDDDDDDDDDDDDDDDDWWFDGDDWWDDFDDDDDDWWWWWDDDDDDDDDDDDDDDDDWWDDDDDDDDWDWWDDDDDDDDDWWWDWD
DDDWDDDWWDDDDDWWDDDDDDDDDDDDDDDDDDFDDDDDDDDDDDDDDDDDDWFFIDIDIDDFDDDDIDDDDDWWDDDWWWWFWDDDFDDFDDDDDDWD
DDDDDDDDDDDDDDDDDDDDDDDDDDDDDWFDDDGDDDWDDDDDFWWDDDWFDDFWDWDIDWWWDDDDDDDDDDFDDFDDDIDWFDMFWWFDDDDDDWWD
DDDDDDDDDDDDIDDDDDDDDDDDDDDDDDIDDDDDDDWWWWDDDDDDDDWWFDDDDWDDDDDDDDDDDDDDDDWWWWWDDDDDDDIDDDDDDDDWWDDD
DDIDFDDDDDDDDDDDDDDWFDDGDIDDDDDWWFWWDDMDDDDDGDDWWDMDDDDDDWWDDDDDDWFDWFDDWWDFDDWDDFDDIDDDDDDDDDDDMDDD
DDDDDDDDDDDDDIDFDDWWWFDDDDDDWDDDDDDDDDFWWDDDDDDDWWDDDDDDDDDDWFWDDDDDDDDDDDDDDFWDDIDMDWWDDDDDDDDDDDDD
DDDDDIFDDDDWWDDDDDDDDDDWWDDFDDWFWWWDDDDDDDFWFDFWDDWDIDDDDDDWWFWWDDDDFDDDDDDDDDWWFDDDDDDDDWDDDDWDDFDD
DDDDDFDDDDDDDDDDDDDDDDDDDFDDDWDFWWDFWWFFIFWWWDWWWWWDDDDDDDDFWDFFDWWDDDDDDDDDDDDDDDDFDDDWDDDDDDWDFDDD
DFDDDDDDDDDDDDWWDDDDDDFDDWWDDDDDDDDDDDDDDDDDDDDDWDFDDDDDDDDFWWWWDDDDDDDDDDDWFDDDDDDDDDDDDDDDDDWDDDGD
DDDMDDWFDDDDDDDWWWDDFDDDDDDDGDDDDDDDDWDDDDDDFDDWDDWWDFDMDDWWFDDDDDDDDDDDDDDDFDDDDDDFDDDDFDDDFWWDFDDD
DGDDDDWWDDDIDDDDDWDFWWDWWWFDDWWDWWDDDWWDDDDDDDWWWDDDFWFDDDDDDDWFDDDDDDDDDDDDDDDDDDDDDDDWWDDDDDDFDDDD
DFWWWWWDDDDDDDDFFIDWDFDDGFDDDDDDWWDDWFDDDDDDDDDDDDDDDDDDDDMFDDWDDDDDDDDDGDDDDDDDDDDDDDDDDDDDDDDMDDDD
DDDIDDIDDDDDDDDDGDDDDMDDDDDDMDDDDDDDDDDDDIDWWDDWWDWDDDDDDDDDIDWWDDDDDDFDDDDDDDIDDDDDDFWWDDDDDMDDDDFD
DDDDFDDDDDDDDDDDDDDDDFWDWWWDDDFDDDDDDDDDMDDDDDDDWWDDDDDDDDWDDDDDDDFDDDDDDDDFWDDDDDDDDDDDDDDDDDDDDDWD
DDDDFDDDDDDDDDDFDDDDGFDDDDDFDDIDDDIDDDDDDDDDDDDDDDDDDDWDDFDFWDDDDDDDDDDDFWFDDDDMFDDDWWDDDWWDDDDDWDDD
DDDWWDDDIFDDDDWWFDDDDDDDDDDDDDDFDDDDDWDDDDDDDDDDDDDDDWWDDDDDWWDDDDFDDDDDDDDDDIFFWDDDDDDDDDDDDDDWDDDD
DDDDDDWWDDDDDDDDFDDDDDDDWFDDDWWWDDDDDDFDDDDDDDDDDWWWDWFWFDDDWDFDDFWDDDDDIDDDDDDDDDDDDDDDDWWDFDWDWDID
DDDDDDDDDDDDDDFWWWDFWDDDWWDDDDFWFDDDWDDDDDDDDDDDDFDDDWWWFDDDDDDDDDWDFWWDDFDDDDDDDDDDDDDFWWFWWDWDWWDD
DDDDWWDDDDDDFWWDDDDDWDWWDDDDDDWWDDDDDDDDDFDFWDDFWWWDDWDDDDDDDDDDFWWDDDDDDDDDDDDIDDFWWWDDWDDDDDDDDDDD
DDDMDDDDDDDWDDWWDDDDDDDWWDWDDWDDWFDDDDDDDWWDWDDDDDDDDWDDDDFDDDDDDDDDDDDDDDDDDDDDDDDDDDDDDDDDDIDDDFWD
DDDDDDDDDDFGFDWDDDDDDDWWDDDDWWDWWDDDDDDDDDDDDDDDDDDDWWFDWDDDDWDWDFWFDDDDDDDDDWDGDDDDDDDDFWDDDDDDDWDD
DDDDDDDDDDFDDDWDDDDDDDDDDWDDDDDDWWDDDDFIDDDDDDDDDDDFDDDDDDDWFDDDFDDDDDDDWWDFWWFDDDDDDDGDFDDDDDDFDDWD
DDDWWDDDFDDDDDWWDWFDDDDDWWDDDDDDDDWFDFWDDDDDDDDDDDWWDDDDDDFWDMDFWDDDDDDDFDDDMDDIDDDDWWFDDDDDDDDDDWDD
DDDDDDDDDDDDDDDDFDDWDMDDMMDDDDDDDFWWDDDDDDDDIDDWWWDDDDDIDDFWWFDWWDWWWWWDDDDWFDDDMDDDDDFWDDDDDDDDDDDD
DMDDDDDMDDDDDWDDDDDDDDDDDFDDFWDDDDDDDDDDDWWDDDDDDDDDDDDDDDDDDDDDDWWDDWDDWWWFWDWWFDDDDDFDFIDDDDDDFWFD
DDDDDDDDWWFDDWWFDDDDDFWWDWDDFWDDWWDIDDDDDDDDDDDDDDDDDDDDDDIDWWDDDDWWDDDMDDDWDDDDFWWWWDDDWDDDDDDDFDDD
DDDDDDDDDDDDDDDDDDFIFDGFFDDDWWDDDIDDDDDFDDDDWFDDDDDDDWWDDDDDIDDDDDDIDDDDDDDDDFDDDDDDDDDWFDDDDDDFDDDD
DDDGDDDDDFDWWFDFWWWFDWDIDFDDDDDDDDDDWDWDDDDWWDDIFDDDDDDDDDDDDDWDDDDDDWWDDDDDDWDDDDDDDWDDWDFDWWDWWWWD
DDDDDDDDDDDDDDDDDDDGDDDDDDDDDDDDDGDWDFDDDMDDDDMDFDGDDDDDDDDWWDWWFDDDDDDDDDDDFWDDDDDIDWWWWDMDDDMDDDDD
DDDDDDDDDDDFDDDDDDDDDDDDDDDDDDDDDGFDDDDDDDDDDFDDWDDDMDFDDDDDDDWDDDDDDFDDDDDWWWDDDDDDIDDWDDIDDDDDDFDD
DDFFWDDDDDWWDDDDGFDDDDDDDDFDDDDDDDDDDDMDFDDDDWDDDDDDDFWDDDDFDDDDDDDDWWDDDDDDFDDDDFFDDWWWDDDDDDDDDWWD
DDWDDDDDDDDFDFWWDFDDDDDDDWWDDDIDDDDFWWDDDDDDDDDDDDDFDDWWFDDDDDDDDDWDDDDDDDDDWWWDDWWDDDDFDDDDDDDDDDDD
DDDDDDDDDMIDDDDDIDGDWFDDDDDDMDDDDDDDDDWDDGDDDFDDDDDWDDIDDDDDDDDWFFDDDDDDIDDWDDMDDDDDWWFWDDDFDDFDDDFD
DDDDGDDWWDDDDFFWDDDWDWDDDIDDDDDDDDDDDFDDDDDDDDDIDDWWWDDDMDDDWWFWWDDDDDDWFDDWDDDDDDDFDWDDGFFDDDDDFDDD
DDDDDDDDDDDDDDDDDDDDDDDDDDDDDDDDDDDDDDDDDDDDDDDDDDDDDDDDDDDDDDDDDDDDDDDDDDDDDDDDDDDDDDDDDDDDDDDDDDDD