;Map made by Santella Agustin
;element index
;  D : Diert
;  M : Mountain
;  W : Water

; starting the level:
DDDDDDDDDDDDDDDDDDDDDDDDDDDDDDDDDDDDDDDDDDDDDDDDDDDDDDDDDDDDDDDDDDDDDDDDDDDDDDDDDDDDDDDDDDDDDDDDDDDD
DDDIDFDDDDWWWDDDDDWFDWWWDDWDDDDDWWWDDDDDDDDDDDFDDDDDDDDDDDDFDDWWDDMDDDFDDDDDDDDDDDDDDDDDDDDDFDFWWDGD
DGDDWWDDDDDDDDWDDDWDDDDWWFDDWWFWWWDFWWDDDDWWDDWDDDFWFDDDFDDWWWWWDDGDDDDDDDDDDDFDDDDDDDDDDDIDWDDDDDFD
DMDDDDDDFMDDDFIDWWWWDDDDDGDDDDWDDDMDDDDDDDFDDDWDDDFWWDDDWWDDDFWWWDDDDDDDDDDDDDWDDDDWWDFDDDFWWDDDDDMD
DDDDDFIFDFWWDWDWWFFWWDWFFFWWWWWDDDDDDWFWWDDFDDDDDDWWDDDMDDDDDDDDDDDDDDDDDDDFIDDFDDDDDDWWFDFDDDDDDDID
DGDFWWDDFDDDDWWDDDIDDDWFDDFDDDDWWDIDDDDDDDDWDDDDDDDDDDDDIDDWWFDWDDDDDDFDDDDDDDDDFWWDDDDDWWDDDDDDDFDD
DDDWDDDDWFDDDDDDDDDDDDDDDDWDGFDDDDDDDDDDDDFDDDDFWDDDWFFDDMDDDDFWWFFDDDDDMDDDDDFWDDWWDDDDDDDDDFDDFWDD
DDDWWDDDDDDGDDIDWWDFDDIFDDDDMDDWWFFDDWDDDDIDMDDDWFDWWDDDDDDDDDDDDDDDDDDDDDDDDDDDIDDDDDDDDDFWWWDDDDDD
DDWDDFWFDDDDDGDDDDDWWDDDWWDDDIFDDDMDWFDDWDDDFDDWWDDDFWDDDDDDGDDDDDFDDGDDDDDDDFDDDDDIDDWWDDDDDDDDDDDD
DWDDDDWWDDDDDDMDDDDDDDDWDDDDIDDDWWFDDDDWWDDFDGDDDDFFDDDDFWWDDWFDFDIFDDWWWDDDDDDDDDDDWDDDDDDFDDDDDDDD
DDDDDWWWWDDIDDDDWWDWDDDDDDDMDDDDDDDDDDDDIDDWDDDWWDWWWDDFWWDWDDDWWFDFWWDDDDDDDDFDDDDWDWWDDDDGDDDDDDDD
DDIDDMDDDDDDDDDDDDDWWFDFDDDDDDDDDDDDDDFDDDDDDFIDDDDDDDDDDFWWDFDDDWFWDDDDDDDDDDDDWDWWWDDDDDDDWDDDDDDD
DDDDDDDDDDDDDDDWDDDDDDFDDDDDDDDWWDDDDDWWDDDFDDDDDWDDDDDDDDWDDWDDDWDWWDGDDWWFDDDFDDDDFDDDIFDDWWWDDDWD
DDDFDDDDDIDDDDFDDDDDDDDDDDDDDDDDDFWWDDDDDDWWDDDDDDDWDDDGFDWDWWDDWWDDDDDDDDDDFWWWDDDDDMDDDDDDDDWWDDWD
DIDIDDDDDDDFDDDGDGDDDMDDGDDDDDDDDDDFDDDGDDDDDDDDDDWWDDDDDWWWFDDWWDWWFDDDDDDDIDWFDDDDDDDDFDDIDWWDDDDD
DDIDDDDDDDDWWFDDDDDDDDDDIDIFDDDDDDDDDWDDDFDDDDDDDDFDIDIDDDDDDDDDFDWWDMDDDDDDDDDDDDDDDMMDDDDDDDMDDDDD
DDDDDDDWWDDDDDDDDDDDDDDDDDDDDDDDWDDDWWDDFWWWDWDDDDWDDDFWDDDDDDIDDDDDDDDDDIDDFDDDDWDDDDFWDDDDDDDDDMDD
DDDDDDDDDDDDGDDDDWWDDFDDWWDIFDDDWWDWDDDDDWWWDDDDDDWWWDDWWWWWFDDDDDDDIFDIDDDDWWWDWWDWWDDDDDDDDDDDDDDD
DDDDDDDDDDDFDDDDDDDWWDDDWWDDWDDWDDFDDDDWWFDDDDIDDDDDDDDDDDDDMDDDDDDDDWWDWWDDDDIDDDDDDFDFDDDIDDIDDDID
DDDDDDDDDWWWDDDDWFDDDDIDDDDFWWWWWDDDDDDDDDDDDDDWDDDFDDDDDDDDDDDDDDDDFDDFWWDDDWDDDDDDDWDWFDDDDDDDDDFD
DDIDDDDDDDDDDDDDDDDDDDDDDDDDDDDDDDDDWWWFDDDDFDDWWFDDDDDDDWDDDDGDDDDDDDWWDDDDDWWFDDDDDMDWWWDDDDDDDFDD
DDDFWWDDDDDDDDDDDDDDDDDDDDDDDDDDDDDWWDDDWWDWWDDDDDDFDDDDDDDDDDDDDDDIDDDWDDMDDDDDDDDDIDDDDDDDDDDDDDDD
DDDGDIDDDDDDDDDGDDDDDDFDFDGDDWWDDDDDDDDDDDDDDDWDDGDWWDFDDDDDIDDDDDDDDDDDGDDFWWDDDDDDDFGDDDDWWFFDDDFD
DDDDDDDDDDWDDDDDDWDDDWWDWWFDDDDWFDDDDDDDDDDDDDDDDDWDDDDDDDDDDDDDFDDDWWWDDDWWDDDDDDDDDDDFDIFWDDWWFDDD
DDDWWWDDIFDDDDDWDDDMDDDDDDDDDDWDWDDDDDDDDDDWWDDDDFDDDDDDDDDDDDDDDDDFWDDDDDDDDDDDDFDDDDDWWDDWDDWWWDDD
DDDDMDDDDDDDDDDDDDDDDMDDWWDDDDDWWDWWDDDWDWWDDDDDDDFDDDDDDDDDDDWWDDWDDDDWFDWWDDDDDWWWDDDWFDDWDGDDDDDD
DDDGDWFDDDWFWWDFFWFDDDWDDDDDDDDDFDDDDIDWWWDDFDDDWWWDDDWWDWDFDDFDDDDDDDDWFDDWWWWFDDDDDDFWWDWWDDDFDDDD
DDDDWWDDDDWDDFWWDIDDDDWWDIDDDDDDDDWDDDDDDDDDDDDDDDFDDDDDDDDDDDDDDDDDDDDDDDWWWWDDMDWWFDDDDDDDDDFWWDDD
DDWDMDDDDDDDDDDFDDDDDDDDDDGFDDDDDDWWDFDDDDDDDDWDFDDIDDDWDDDDDWDDDDDDDDDDDWWFDDDDDDDWWDDDWDDDMDDDDDDD
DDDDFWWWDDDDDDWWFDDDDDFDDDDDDWWDDDDDDDDDDDDDDWFDDDDDDWDWWDDDFDDDDDDDDDDFDDDDDWWFDDDDDDDDDDDDDDFFDDFD
DDDDDDDDDDDDDDDDDIDDDDWDDDFDFDDDMDDDDDFDDDDDDDWFDDDDFDDDDDDDDDDDDFDDDDDDDDFDDDDDDDDDDWWFDDDDMDWWDDDD
DFDDDDDDDDDDDDDDFDDDDDDDWDDDWDDDDDDDDDDDDDIFDFDDDDDDDDDDWWDDDDDDDDFWWWDFWDDDDFDDDDDDDDDWWFDDDMDDDDDD
DDDDDDDDDDWDDDDWWDDDDDDWWFMDWWFWWDDDDFWFDFDDDDDDDDDDDDDWDDDWDDDDDDDDDDDDDDDDDDDIDDDDDDDFDDFWDDDDDDDD
DDDDFWWWDWWWFFDDDDDFDDIFDDFDDDDDDDDDDDDDDWDDDDDDDDDDDWFWDDWWDDDDIDDDWDDDDDIDDGFDDDDDDDDGDDDWDWWFDDDD
DDDDDDWFDDDDWWDDDDDDDDDFDDDFDDDDDDDDDDDDDWFFDWDDDFWFFDDWWDDDDWWWDDDFWDDDDDDIDDDDDDDDDDDDDDWFDIDDDWDD
DDDDFDWWWDDDDDDWFDDDDDDDDDDDDDDDDDDDDDGDDDFWDWWFDFDDDDDDDDWWDFDFDDDFDDDDDDDDDDWWDFFDDWDDDDWWDDDDFWWD
DDDDDDFDDMIDDDFDDDGDDDDDDDDDDDDDFDDDDDDDDDFDDDDDDDFWFWDDDDWDFDDDDDIDDDDDFDGDDDWWDDDDDDDWDWDDDDDDDDDD
DDGDFDDDDDDDDDDDDDDDMFDFDDDDDDDDDFDDDWWDWWDDDDDDDDDDDWWDDDDWWDDDGDMDDDDDDFDFIDDDDDWFDDWDDFWWWDDDDDDD
DDDFDFDDDDDDDFDDWDFDDFIDDDDDMDDDDFDDDDDDDFWWDDFWWDDDDDDDDDDMDDDDIDDDDWDDWWDDDDDFDDWDDFWWWFDDDDDWDDDD
DDDDDWWDDDDDDDDFDDDDFDDFWWDDDDDDDGDDDGDIDDDDDDDMDDDDDDDDMDDDFDDDDDMDDWWFDDDDWDDDDDDDDDDDDDFDDDFDDDDD
DDDDDDDDDDDDDDDDDDDDDDDDWFDWFDDDDDDWFDMDDDDDDDDDDDDDDDDDFDDDDDDDDDDDDDDDDWFWWDDFDDDWFDDDDDWFDDDDDDDD
DDDDDDDDDFDDDDDDDDDDDDDDFDDWFFWWDWWWFDDDDDDDDDDDDFDDDDDDDDDDFDDDDDDIDDDWWWDDDDWWDWFDDDDDDDWWDDDFDWDD
DDDDDDDDDDDDDDDDFDDDDDDDDDDWDIFFFDDDDDDDDDDIDDDDDWWDWWDGDDDDDDDDDIFDDFDDDDDDDDDDFDDDDWWDDMDFWDDWWWFD
DDDDWWDDDDDDDDDDWDDDDDDWDDDWDDDDDDDDDDDDDDWFFDDDDDDDFDDDDDDDDDDDDDDDDDDDDDDDDDWFDDFWDDMDDDDDWWDDWDDD
DDDDGDDFDDDDFDDDDDDDDDFDDDWWFDFDDDWWWDDFDDDDDDDDWDDDDDDWDDDDFDDDDDDDDDDDDDDDDWWDDWWDDDDDDDDDDDDDDDDD
DDDDDDFDDFWWWDDDDWDDDDDFDDDDWWWDDDDDDDFDDDDDDDDDDFDDDDDDDDDFWWDDDDFMDDDFWDDDDDDDDDDWDDFGDDDDDDDWDDDD
DDDFDDDDDDIDDDDDDWDDDDDWDDDDDDDDDDDDIDDDDFDDDDDDDDDFWWDDDDDDDDDDDDDDFDDWWDWWFDFDDDFWFWWDDDDDDDWDDDDD
DDFDDDFDDDDDDFWWDDDDDDDWWWFDIDDDDDDDDIDWWFDDFDFDDDFMDWWDDDDDDDDDWDDDDDFWFDMDFDDDDDFDDDDDDDDDDDDDDDDD
DDDDDDWWDDDDIFFWDDDDDDDDDDDDDDWDFWFDDDDDWWDDDDWDDDDDDFWWWWDDDDDDDDDDWWDDDDDDDDDDDDDDDDWWDDDDDDDDDDMD
DDDDDDDDWDFDDDWWDDDDWDDDDDDDDDDDFWWDDDDDDDWFFWWDDDDDFDDDDDDDDDDDDDDDDDDDDDDMDDFFWDIDDDDDDDDFIDIDDDDD
DDDDDFDFMDWWDDDDDDDDDDDDFDGDDDDDDDDDDDDMDFDDMDDDDDDDWWDDDDWDDDDIDDDFDDIDDDDDDDWWDDDDDDDDDDDDDDDDFDDD
DDDDDDDDDDDDDDDDDDDDDDFDDIDFDDFDDDIFMDDDDDDFDDGFDDDDDDDDDDDDDIFIDDDDDDDDWWDDDDMDDDDDDWDDDDDWWFDDDDFD
DDDDDFDDIDDDDDDDDDDWDFWWWFWWWWWDDFDDDFDFMDDDDDDDDDDDIDDDDDDDDFDDDGDDDFDDFDDFDDFWDDDDDDDDDDDGFDDDDDDD
DMDDFDDDDDDDFDDDDDWFDFDDWWDDDDDDDDDDDDDWDWWDDDDDDDDDDDDDDDGDDDDDDDDDDDDDIDWWFDDWDDDDDDDDIDDDDDDDDDDD
DDDDDDDDDDDDMDDDDDDWDWDDDDFDDDDDDFDWWDDDDWWDDDDDDDDDFFDDFWFDIDDDDDDDDDDDDWWDDDFDDDDFDDWWDWDWWDDIFDWD
DGDDDDDFDDWWFDDDDDFWWWWDDDDDWWDDDWWWDDDDDWWDDDDDFWDDWWDDFWDDDDDDDDDDDDDDDWWWDWDDDDDWDDDDFDDDDDDDWWDD
DDDDDDDWWDDDDFDDDDDDDDDDWWDDDDDDDDDDDDDDDDDDDDDDWWDFDDFDDDDDDDDDDFFDDDDFDDDDDWDDDDDWWDDDDDDWDDDDFDDD
DDDDFDDDDDDDFWDDWDWWDDDGFDDDFDIDDFDDDDIDDDDDDDDFWDDDDDWDDDDDDDWDDWDFDDDDDWWDWDDFDDDDFDDDDDDDDDDDDDDD
DGDDDDDDDDDDFGDDWDDDDDDDDDDDDDDDDWWFDDDWWDDDDDDDWWDDDFWWDDDDDWWDFWWDDFDDWDDDDMDDGFDDWWWDDDDDDFWDFWWD
DDDWDDDFDDDDDDDDIDIDDDDWDDDDDDDDDDDWDDDDFDDDDDDDDDMFDDDWWDDIDDDWWDDDDDDFIDDDDDDDDWFDDWDDDDDDDFDDWDDD
DDWWFDDDDDFWWDDDDDDFDDWWDDDDDDDDDDWWDDDDDDDDDDDMIDDIFDWDDDDIFDDFWDDDDDDDDDDDDDDDDDDDDWWDWDDDDDDFWWDD
DFWDDFDDDDDDDDDDIDWWFDFDDDDDDDDDDDDDDDDDDDDDDDDDDIDDDDIDDDDFDFDDDDDDDDDDDDDDFDDDDDDDFDDDWWFDDDDFWWDD
DWWDWWWFDDDDGDDDDWDDDDDDDDDDDDDDDDFDDDDFDDDDDDFDDDIDDDDFDDDWWWDDDDDDDDDDDDDFWDDDDDDDDDDDDDDWWDDFDDDD
DDDDDDIDDFWFDDFDWDWWFDDDDDWWFDDDDDDDDWDDDDWDFDDDDDDDDDDDDDDDWWDDFDIDDDFDDDDWFDDIDDDDDDDDDDDDDMDDDDFD
DDDDDDDDDDDDDWWDWWDDDDDDWWDDDDDDDDDDDWWDDDWDDDDDDDDFWWDDDWDDDDDWDDDIDDDDDDDDDDDDDFDDFDDDDDDDDDDDDDDD
DDDDIFDDDDDDDDDDIDDFDDDDFDDDWFDDDDDDDDWWDDDDDDDDDDFDDDDDDWDDWDFWWWDDDDMDDDWDIDDDDDDDWDDDDDDDDDDDDDDD
DDDFDDDDDDFWDDDDDDDDDDDDDDDDDDDDFDWWFDDWDDDDDDDDDDDDDDIDWWWFDDWWDDFDDDFWDDDDDDDDDDFWWDDDDDDGDDDDDDDD
DDWWDWWDGDFWWDWWDDDDDDDDDDDDDDMDDDDDDFWWWFDDDDDDDDDDWDDDDDDIDDDDWDMDDDDDDDIFDWDFDDDDDDDDDDDDDWWDDDDD
DDDDFDDDDDDDDDDDMDDDDDWDDDDDDDFGDDMFDDDDDGDDDWFDDWWFDDDDDDDDDDDWWDDDDDDDDDDGDDDDDDDDDDFWFDDDFWDGFDDD
DDDWWDDDDDWWDFWWDDWDDDWDWWDDFWWDWDDDDDDDWDDDWDDDMDWWDDDDDDDMDDDDDDDFDDDDDDDFDIFDDDDGDDDWWFDDDDWDDDDD
DWWDDDDFIFDDDFDDDDWWDDDDDDDFFDDWWWWFDDDDWWWFDWDGFDDDDDDDDDDIDIDDDDDIDDDWWDDMDDDDDDDDDGFDWDDDDWWDDDDD
DDDDDDDDDDDDDDDDDDDDWDDDDFDWWDFDDDDDDDDDDWDDDDDDDDDDDFFDDDGDDDDDDDDDDWDDDWDFDDDFDDDDDFDDDDDDDDDDWDDD
DDWWDDDDDFWDDDIFWWDFWWWFDDDDDDDDDDDDDDDDDDDDDDDDDDDDDWWDDDDDFDFDDDDWWWDDDDDDDDWWDDDDDDDDDDDDDIFDWWWD
DDDDIDDDDDWWDDGDDWDDDDDDDDDDDDDFDWDWWDDDDDWWDDDDDDDDDIDDDDDFWFDDFGDFDDDDDDDDDDDDDDDDDDDDDDDDDMDWWWDD
DDDDDDDDDDDDDDDFWWDDDDDDDDDDDDDDDWDWDDDDDDDWDDDDDFDDDDDMDDFFDDDIDDFWWFDDDDDDDDWWWFFDGDDDDWFDDDDDDDDD
DDDDDDDDDDFDDDFDDDWWDWWDDDDDDDDIFDDWWDDFDDFDDDDDDDDDDDDDDDDDDMDDDDDDDDDFDDDDDDDDDDDDDDDDDWWDFDDDDDDD
DDDDDDDDDDDDDDDDDDDDWWDDDDDDDDDDMDDDDDDDDDIDDWDDWFDDWWFDDDDGFDDWDDDDDDWWDDDDDFWDDDDDDDDDDWWWDDDDDDDD
DDDDDFDDDDDIDDDIDDDDDDWWWDDIFDDDDDDDDDDDDDDDFDDDDDDDDDDDWFDFDDFWWDDDDWWWWWDDDDWWDFWDDFDDDDDDDDDGDFWD
DDDDDDDDDDDDDDDIDDDFDDDDDDDFDDFDDDDWWWDDDDDDDDDWFDDDDDDDWWDWWDDDDDDDDDDDDDDDDDFDDDWDDDDDDDFDDDDDDDDD
DDDDDDDDDDDDDDDDDDDDDDDDDDDDDDDDDDDDDDDDDDDDDDDDDDDDDDDDDDDDDDDDDDDDDDDDDDDDDDDDDDDDDDDDDDDDDDDDDDDD