;Map made by Santella Agustin
;element index
;  D : Diert
;  M : Mountain
;  W : Water

; starting the level:
DDDDDDDDDDDDDDDDDDDDDDDDDDDDDDDDDDDDDDDDDDDDDDDDDDDDDDDDDDDDDDDDDDDDDDDDDDDDDDDDDDDDDDDDDDDDDDDDDDDD
DDDDFDDDDDDDDDWWFWWWDDFGDDWDDDDDDGDFDDDDDDDDDDDDDDDDDWWDDWWDDMDDDDDDDDDDDDDDDDDDDDFDDDDDWWDDGDDFDDDD
DFDDDDDFFDDMDDDDWDDDDDWFDDDDDDDFDDFDFDDDDDDDDDDDWWFFDDDDDDDDDDDFWDDDDDDDDMDDDDDDWDDDDDDDDDDDMDDDDWDD
DIDDWWDWWDFDDDDDDMDDDWWDDDDDDWDWDDDFWDDDDDDDDFDDDDDWFDDDDDDDDDFFDDDDDDDDFDFWDDDDIFDWDDDDDDDDDIDDWWDD
DDDDWDDDDDWWFDDDDDDDDDDDDWDDFWWWWWWWWDDDDDDDDDFDDDWWDDDDDDDWWDWDDDDDDDDDWDDDDDFDDDDWWDMFWFDDDDDDMFWD
DWWDWDDDIDDWWWWDDDDWWDDWDDDDDDDDDDDDDDFDDDFDWFDDDDIDDDDDFDWDDDWDDDWWDDDWWFDDDDDDDDDDFIDDWDDDDDDDDWDD
DWWDDFFDDDFDDWWWDWDFDDWDDDDDDDDWWDDDDDDDFDDFWFDDDDDDFGDWWDDDDDWWDDDDDDMDDDDDDFDDDDDDWDDDDDFDDDIDDDWD
DDDFDWDDDWWDDDDDDWWWDDDWWWDWDWDDDDDDDDDDDDDDDIDDDDDDDFDFDDDWWWWWDDDDDDDDWDDDDWWDDDDFDDDDFDDDDDDDDFDD
DDDWWDWDDFDIDDDDDDDDDDMDDDDDDDDFDDDDDDDDDDDDFDDDDDDIDMDDDDFDDDDDDDDDDFWWDDDFDDDDDWWDDDFDDDMDDDDDDDDD
DFWFDWWDDDDDDDFDDFDDDDFDFDDDDDDWDWDDDDWDDDWDDDDDDDDDDDDDDDWFDDDFDDDDDDDFWDDIDDFDWWDDDDIDDDDDDDFDDDDD
DWWDDDDWDDDWDDDDDDDDDDDFDDFWFFDWDDDDDFDDGDDDDDDDDDDDDWWDDFWWDDDWWWWDDDDFDFWDDDDDWFWWDDDWDDDDDDDFDDDD
DDDDDDFWWDDWFDDDDDDDDDDDDDWDDDDWWDWFDDDDDWDDFDDWWDDFDDDDDFWFDIDFWWWDDDDIDDDDDDFDWDDDDDDWDDDDDDDDMDDD
DWDFDFDFDDDDDDDDDDDDDWWWDDFWWDDDDDDDDDDDDDDDDDDDDDDDDWDDDWWWDDDDDFDDDDDDDDDDFWWWWFDDDDFDDDDDDWDDDDFD
DDDDDDFDFFWDDDDDDWWDDDDDDDDDDDDWWDDDDFDDDDDFDDDDDDIFFWDDFDDDWDDWFDDDDDDWWDDDDWDDDFDDDDDDDDDDWWWDDDDD
DDWWDDDFWWWFDDDDDDDDDDDDDGDFDDDDDDFDDWFDDDDWDDFDDDDDFDDWWDDFDIFWWWDDDDDFMDFDDWDDFIDDDDWWDIDDDDDDDDFD
DDWDDDWWWDIDDDDMDDDDDDWWDDDDDDDDDDDDFWDDFDDWWWDDWWFDDDDDWDDDDDDFWWFDDWDDDDDDDDDDDDDDDDFWWDFDFDDDDDFD
DDDDDWDFDDDDDWWDDDDDDDIDDWWFFDDDDDDDDDDDWDFDDDFDDDDDWWDWWFDDWWWWDDDDFDDDIDDDIDDWFFDDDDDDDDDDDDDDDDDD
DDDWFWDDDDDDGFDDDDDDDDDDDDMDDDDDDDWWDDDDWWWFDDDDDDDDDDDDDDDDDDDFDDIFDDDDDDDWDFDDDDDDDDDDDDDDDDDDDDDD
DDDDFWDDDDDDDDFDDDFWDDDDDDFDDDDDIDDDDDDFDDDDDDDDDDDDDWWDFIDDWWDDDDDDDDDDDDFDDDDDDDDDDWWFDGDDDDFDDDDD
DWFDDDDDDDDDDDDDDDDWWDWWDWDDDDDDDDWWDDDDDFWWDDFWDDDDFDDFDFWWDDDDDDWWDDDDFWWDDDDDDDDWDDDDDDWWDFWWDDDD
DDDDDDDWDDDDDDDDDDDDDWWWDWWDDDDDDDDDDDDDDDDDDDDWDFWWWWDDDDDDWDDDDDDDDDDDWDDWWFIDDDDWWWDDDDDDWWWDWFDD
DDDWDWDDDDDDDDDDGFDDDDFDDDDDDDDFDDDDDGDDDDDFDDWWDDDDDDDDDDDDDDFDDDDDDDFWDDDDDDDDDDDDDDDDFDDDDWFDWWWD
DDDWWWFDDDDDMDDDDDDDDFWWDFDDDDDDDDIDWDDIDWDDDDDDMDIDDDIDDDDDFDDDDDDDDDDFDDDDDWFWDDDDDDDFWWWDWWWDDDWD
DDDDWDIDDDDDFDDDFDDDDDDDDDMDFDDDDDDWWWDFDDDDDDDDDDDDDDDWFDDFDDDDDDDDMDDDDDDDDWWWDDDDIDDDDDFWDDDDDDDD
DDDDWDDDDDDMDDDDDDDDDDDGDDDDDDDDDDDDDDDDDDIDDDDIDDDDDWDDDDDDDDDDIFDDDDDIDIDDDDDDDDDDFDDDDFDDFWDDDFDD
DDDDDDFWWFDDDDDDDDFWWDDDIDFDDDDDDDDIDDDDFDDDDDDDFDDDDWFDDDDDDDWDDDDDDDDDDDDDDDDFDDFWWDDFWWDFWDDDDDDD
DDDDDWDDDDDDDWDDDDDDDWWWDDDFDDDDWWDDDDDDDDFDIDDDDDDDDWWDDDDFDDIDWWWFDDFDWFDDDFWWFDDMDDDDDDDWWWFWDDDD
DDDDDDDDWDDDDDDDDDDDWWDDDDDDDDDFMDDDDDDDDDDDDDDDDDMDFDDDDFMDDDDDDDDDDDDDDDDDDFFDDDDDDDFDDWWDIDDDDDWD
DDDDDDWDDDWDDDDDDWDDDDDDIDDDDWWDDDDDDDDDDDDDDDDDDDDDDDDDFWDDDDDDDDFDDWDDDDDDDDDDDDDDDDWWDFDGDDDFMDDD
DDDDWDWWFDWWDDDWWWDDDDDDIDDWDDFWFDDDWWDDDDWWDDDDDDDDDDDDDDDDDWDDDDWWDDFWWFMDFDFFWWDWDDDDDDDDDDDDDDDD
DDWWDDDWDDDDDDDDMDDDDDDDDWDWDDDWWDDDDDDFDDDMDFDFDDDDDDDFDDDDDDDDDDDDDDFDDDDDDDWWDDWWWDDDDDDDDDDDDDDD
DMDDWDFDDDDWWWDDDDDDDDIDDWDDDDDWFDDDDDWWWFDDWWDDDDDDDDDDDDDDDDMDWDDDWDDDFDDDDDDDIDDDWDDDDDDDDDDDDDDD
DDDDDDWDDDDDDDDDDDDDDDDDDDDDDWDWWDDDDDDFDWWDDDDDDDDDFDDDDDDDDDDDMDFDDDDWWWDDDGDDDDFDDDDDDWWDDDDWWWWD
DDDDMDDDDDDMFDDDDDDFWDDDDDDDFDDDDDDDDWWWWDWWWDDDDDWDDDDDDDFDDFFWDDWWFDWFFDFDFDDDFWWDFDDWDWWDDDDDDDDD
DDDDDWFGDDDFWWFDFDDFWWDDDDDDDDDWDDDDDFDDDFDDDDDFDFWDMDDDDFDDDWWWDDDDDFMDWDDDWDDDDDDFMFWDDDDDDDIFDDDD
DDWWDWDDDDDDDDFDFDDDDDWWWDDDDDDDDDDDDDDDWWDWWDDDDFWWDDDDDDDDDDDDDDDDDMDDDDDDDIDFDDDWDFWWFDDFDDDDIDDD
DDDDDDDFDDDDDDDDDMDDDDWWDDDDDDDDDDFDDMDDMDDDDWWDWDDDDDDFDDDDDDDDDDDDDDFIFDDDDIFWWWWWFDDDDWDDDDDDDDDD
DDDDDDDDDDDDDDDDDDDGDDDDDDDDWWDDDDDIDDDDFDIFDDDWWFDDDDDDDDDDDDFDDDDDWDDDDDWWDDFDDDDDGDDDDDDDDDDDWDDD
DDDFDDDDDWWFFDDDDDDDDDDDDDDDDDDDDDDDDFDDDDDDDDDFDDDDDDDDDDDDDDDIDDDWWFIDDDDDDDDDWFDDDDDDFDWWDDFWDDDD
DDDWWFDDDDDDWDDDDDMFDDDDDDDDDDDDDDDDDDDDFFDDDFWWDDDDWWWDDDDDDDDDFDDDDDDDIDDDDDDDDFDDDDDDDDDDDGFDDDDD
DIFDDDWDWDDDDDDDDDDWDDDDDDDFDDDDDDDDDDDDWWWDDDDDDFWWDWWWDDDDDDDDWDDDDDMDDDDIDDIFFDDDDDDDDFDDDDDDDDDD
DDDDFWWFDDDFDDDFDDDWDDFDDDDDDDWWDDIFDDDDDFDDDDDDDDMDWDDDDDFFDGDWDFDDDDDDDFDDWWDFDIFDDDDDFDDIDDDDDDDD
DDDDDWFDDDDDDDDWWDDDDDDFDDDDFWDFDDDFDIDDDIDDDWDDDDDDDDWWWFWWDDDDWWFDDFDDDDDDDDDIDDDDDWWWFFDDDDDDDDDD
DDDDDWDDDWWDDDDDDDDDDDIDDDDDDDDDDMDDDDDDFFDDDWWDDDDIDDIDDDDDWWDFDDDDDWWFDDDDWWDIDDDDDDDDWWDFDDDDDDDD
DDDFWDDDWFWDDDIFWDDDDDDWWFDDDDDDDDDDDDDWWWDDDDWWDDDDDDDDDDDDDDDWFDDIDDDWWDWFDDDMIDFDDDDWWDDDDDWWWDDD
DFDDWWFDWWFDDDDFDDWDDDDDDFDDDDDDDFDDDDDDDDDDDDDDDDDWWDWWDDDDDDDWWFDFDDGFWWWDDDDDDDWDDFDDDDDDDDDIDIFD
DWDDDDDDWDWWDFDDDDDDDDDDDDDDDDIDDDDDDWWDDDDDDDDWDDDDDDDWFFDFDDDFWWDWWDDDDDDDDDDDDDDDDDFDDDFDDDDDDFDD
DDDDDDDDDDWWDDGDWWDDDDDDDDGDDDDDDDDFDDDFDDDDDFWWDFDDIDDDDDDDIDDDDDDDDFDDDDDWDDDIDFDDDDWDDWWWDDFDDDDD
DDDDDDDDDDWWDDDWDDFDDDDDWDDDDDDDDDDWWDDDDDDDDFDFWWDMDDDDWWDDDDDDDDDDDDDFWWWWDDDDDIFDDDWWDDDDWFWDDFDD
DDDDDDDDDFDDDDDWWFDDDDDWWDDDDDDDDDDDDDDDDFWDDWDDDDDDDIDDDDDFDDWDDWWDDDDDWWDDDDDDDDDDDDDDDDDDWDDDWWWD
DDWDDDDDDDDWFWWDDDDDDDDFDFDDDDDIFDDDDDDDWFDDFDDDDDDDDDDDFWWWWWWWWDDMDDDDDDDDDDDDIDDGFDDDDDDDDDDIDDDD
DFDDDDDDDDDDDDDDDDDDDDDDDWFDDDDFDDDDDDDDIDDDDDDDGFFDDDDDDDDDDWDDFWFFDDDDDWWFWWDDDFDDDDDWWFDDDGDDDDDD
DDFIDFDDDDDDDDDDDDDDDWWDWWFDDDFDFDDWDDDDDDIFDDDDDWWFDDDDDDFWWWDDDDFWDDDDDDDDDDDDWWFDDDDDDDDDDDDDFWDD
DMDDWWWDFDDWFDDDDDMDDDDDDDDDDDDDDDFDDDDWFDFDDDDWWDDDDDDDFWWDDDDDDDDDDDDDWWDDDDFDWWDDDDWDDDDDDDWWDWWD
DDDIDDDDIDDDDIDDDDDDDDDFDFDDDDDIDDDDWWDDFWWDDDWFDDDDDDDDDWWDDDDDWFDDDDDDDDFDDDWWFFWWFDDDDDDDDDIDWDID
DDDFWWDDDWDDDDDDDDDDDFDDDWWDDDDFFWFDDDDDDDIFDDWWFDFDDFDDDDDDDDDWWDDDDDDDWWWDFWDDDDWFWWDDDDWDDDDDDDDD
DWDDDFDDDDDDDDDDDDIFDDDDDDWDDDFDDWWDDDDDDDDDDDWWDDWDDDDDDDIDDWWDDDDDDDDDDDDDDDDDWDDWDDDDDDIDWWFDDDDD
DWWWDDDDDFDDDDDWWDDWWDWFWDWDDDDFDDFWDDFDDDDFDDDDGFDDDDWDDDDDDDDDDDDDDDDDDDDFWDDDWFDWWWDDDDDDFDDFWWDD
DDDDDDDDDDDIDDDWDWDDDDDDDDWDDDDMDDDDDDDDWWWWWDDDDDFWFDDFDDDDDDDDDDDDDDDDDDDWWFDDDIDFDGDDDDDDDFDDWWDD
DDDDFMDDDDDDDWDDFWWDDGDDDWDDDDDDDDDFDDWDDDDDWWDDDDDDGDDDDDDIDGDDDDDDDWDFDDWWFDDWDDDDDDDDDDDDFWDDDDDD
DWFDDFWWFDWDDDDDDDFDDDDWWFDDDDDDDDDDDFWDIDWWWFDFDWWDIFDDWWDFDDDDDDDDWWWWDWWDDDDWWWDDDDDDDDIDDDDDDDDD
DWDDDDDDDFDDDDDWWWWDDDDDDDDDDDDDDDDDDWDDFDDFDDDWWDDDDDDDDFWWDDDWWFFWDDDDDDDDMDDWWDDDDDDDFDDDDDDIDWDD
DDDWWDDDDDDDWDDDDDDDDDDDDFDDFDDWWDDDIDDDDFDDDDIDDDFWWDDDDDDDIDDFWDDWDDDFDWWDDDDDDDDDDIDDWWWDDDDDWWDD
DDDDDIDDDDFDIDMDDDDDDDDDDDFDDDDDDDIDDFDDDDDDDDDFDDFDFDDDDDDDDDDDWWFDFDDWWWDIDDFDIFDDGDFDDDDDFDDWDFWD
DDDDDDDDDWWFDGDDDDDIDDDDDDDDWWDFDDDDFWDDDDDDGDDDDWWDWFDWDDDDDDDDDDDDDDDDDDDDDDGDDDDDDDWDDDDDWWDDDFWD
DDDDMFDDDDDDDIDDDDDDDFDDDDDDDDDIDDDDWWFFWDDWDDDDDDDFWWFWWDIDDDWWDDDDDDDDDDDDDWDDDDDDMDDDDDDDDDDDDDDD
DDDDFWWDDDFDDDDDDDDDDDDFWDDDFDDDWFFDDDDDDDWWDDFWDDDDDDDFDDDDDDDDDDWWDDFFDDDDDWWWDDDDDDDDDFDDFDDDDDWD
DDDDDDDDFDWWFDDWWDDDDDDDDDDDDDFWWWWDFWDDDDDDDDDDDDFDIFDDDDDDDDDFDDDWWWWWWDDWDFDDDDDDWDDDDDDDDDDFDDDD
DWFDDDDDWWWFDDDDWWDDDIFDDDDDDDDDDDDDWWDDWDGDDWDDDFWWDWDDFDDDDDDDDDDDDDDDDDWWDDDDDDDFDDDDFDDDDFDDDFDD
DDDDDDDDDDDDDDDDDDDDDFWFDDDDDDDFIDDDMDFDDDDDFDDDDDDDFWWDWWDDDIFDDDIDDDWDDDDDDDDDDDDDDDDDDDDDDWWDDWWD
DDDDDDDDDWDDDDWWDDDDFDDFDDFDDDDDDDDDDDDDDDDWWDDDFDDDDDDDDDDDDIFWDDDDDDDDDDDIDIFDDWWWDWWWDDDDDDWWDDDD
DDDDDDDDWDDDDDDDDFDDWDDDDDDDGDWDWWFIDDDDFWWWDDDDDDDDFDDDDDDDFDDDDDDFDIDDFDDDDDDFDDDDDDWWDWWFDDDDDDGD
DDDDDMDDDWDDDDDDDDDFDDDDFWDDDDWDFDDDDDDDDDDIFDDDDDDDIDDWDDDDDDDDFDDDDDDFDDDDDDDDDDWDIDDMDDFDFDDDDDDD
DFDDDDDDFDDDDDDDDDDDDDDDDDDDDFDDDDGDDDDDDWWDDDFDDDDDDDDWWFDDDDDDDDDDMDDDDWDFDDWDFDDDDDDDDDDDDDDDDDDD
DDFDDDDDDDDDDWWDMDDDWWDGDDDDDDDDDIDDDDDDDDDDDFWWWDDDDDDDDDWWFDFDDDDDDDDDDWWWDWWDDIFDMDDDDDDDDDDDDWWD
DDWDDDDDDIDDDDDDDDDDDDWDDWDDDDDDDDGDDDDFDDDDDDDDDDDDDIFDDDGDDIDDDDDDDDDWDDDGDDDDDDMDDDDDDDDDDDDDWWDD
DWWDDDDDDDDDDDDWDDIFDDWDDDIDDIDDDDDDDDWWDWFDDDDDDDDDDDDDDDIDWDDDDDDDFDDDDDDDDFDDDDDDWWWDDDDDDFDDDDDD
DDDWWDDFDDDDDDDWDDDDMFWWDDDDFFDFDWWDDDDWWDDIDDDDFDDDFDDDDDDDDDDFWWWFWWDDDDDDFWDDDDDDFDDDDIFDDWDDDIDD
DWWDDDDDDFWWFDFDDIDDDDWDWWFFWWWWFFMDFMDDDDDFDMFDWFDDDDDDDDDDDDDFDDDWFDDDDDDDWWWFDDDWWWFDDDDDWWDDDDDD
DDDDDDDDDDDDDDDDDDDDDDDDDDDDDDDDDDDDDDDDDDDDDDDDDDDDDDDDDDDDDDDDDDDDDDDDDDDDDDDDDDDDDDDDDDDDDDDDDDDD