;Mapa hecho por Ian Sanna
;Los elementos en el mapa corresponden de la siguiente manera
;  X: Valle
;  Y: Montaña
;  M: Mar

; Empezando el nivel:
YXXXXXXXXMMMMXXXXXXXXXXXXXXXXXXXXXXXXXXYYXXXXXXXXMMMMXXXXXXXXXXXXXXXXXXXXXXXXXXY
YXXXXXXXXXXXXXXXXXXXXXXXXXXXXXXXXXXXXXXYYXXXXXXXXMMMMXXXXXXXXXXXXXXXXXXXXXXXXXXY
YXXXXXXXXXXXXXXXXXXXXXXXXXXXXXXXXXXXXXXYYXXXXXXXXMMMMXXXXXXXXXXXXXXXXXXXXXXXXXXY
YXXXXXXXXXXXXXXXXXXXXXXXXXXXXXXXXXXXXXXYYXXXXXXXXMMMMXXXXXXXXXXXXXXXXXXXXXXXXXXY
YXXXXXXXXXXXXXXXXXXXXXXXXXXXXXXXXXXXXXXYYXXXXXXXXMMMMXXXXXXXXXXXXXXXXXXXXXXXXXXY
YXXXXXXXXXXXXXXXXXXXXXMMMMXXXXXXXXXXXXXYYXXXXXXXXMMMMXXXXXXXXXXXXXXXXXXXXXXXXXXY
YXXXXXXXXXXXXXXXXXXXXXMMMMXXXXXXXXXXXXXYYXXXXXXXXMMMMXXXXXXXXXXXXXXXXXXXXXXXXXXY
YYYYYYYYYYYYYYYYYYYYYYYYYYYYYYYYYYYYYYYYYXXXXXXXXMMMMXXXXXXXXXXXXXXXXXXXXXXXXXXY
YYYYYYYYYYYYYYYYYYYYYYYYYYYYYYYYYYYYYYYYYXXXXXXXXMMMMXXXXXXXXXXXXXXXXXXXXXXXXXXY
YYYYYYYYYYYYYYYYYYYYYYYYYYYYYYYYYYYYYYYYYXXXXXXXXMMMMXXXXXXXXXXXXXXXXXXXXXXXXXXY
YYYYYYYYYYYYYYYYYYYYYYYYYYYYYYYYYYYYYYYYYXXXXXXXXMMMMXXXXXXXXXXXXXXXXXXXXXXXXXXY
YYYYYYYYYYYYYYYYYYYYYYYYYYYYYYYYYYYYYYYYYXXXXXXXXMMMMXXXXXXXXXXXXXXXXXXXXXXXXXXY
YXXXXXXXXXXXXXXXXXXXXXXXXXXXXXXXXXXXXXXYYXXXXXXXXMMMMXXXXXXXXXXXXXXXXXXXXXXXXXXY
YXMMMMXXXXXXXXXXXXXXXXXXXXXXXXXXXXXXXXXYYXXXXXXXXMMMMXXXXXXXXXXXXXXXXXXXXXXXXXXY
YXMMMMXXXXXXXXXXXXXXXXXXXXXXXXXXXXXXXXXYYXXXXXXXXMMMMXXXXXXXXXXXXXXXXXXXXXXXXXXY
YXMMMMXXXXXXXXXXXXXXXXXXXXXXXXXXXXXXXXXYYXXXXXXXXMMMMXXXXXXXXXXXXXXXXXXXXXXXXXXY
YXXXXXXXXXXXXXXXXXXXXXXXXXXXXXXXXXXXXXXYYXXXXXXXXMMMMXXXXXXXXXXXXXXXXXXXXXXXXXXY
YXXXXXXXXXXXXXXXXXXXXXXXXXXXXXXXXXXXXXXYYXXXXXXXXMMMMXXXXXXXXXXXXXXXXXXXXXXXXXXY
YXXXXXXXXXXXXXXXXXXXXXXMMMMXXXXXXXXXXXXYYXXXXXXXXMMMMXXXXXXXXXXXXXXXXXXXXXXXXXXY
YXXXXXXXXXXXXXXXXXXXXXXMMMMMMMMXXXXXXXXYYXXXXXXXXMMMMXXXXXXXXXXXXXXXXXXXXXXXXXXY
YXXXXXXXXXXXXXXXXXXXXXXMMMMMMMMXXXXXXXXYYXXXXXXXXMMMMXXXXXXXXXXXXXXXXXXXXXXXXXXY
YXXXXXXXXXXXXXXXXXXXXXXMMMMXXXXXXXXXXXXYYXXXXXXXXMMMMXXXXXXXXXXXXXXXXXXXXXXXXXXY
YXXXXXXXXXXXXXXXXXXXXXXXXXXXXXXXXXXXXXXYYXXXXXXXXMMMMXXXXXXXXXXXXXXXXXXXXXXXXXXY
YYYYYYYYYYYYYYYYYYYYYYYYYYYYYYYYYYYYYYYYYXXXXXXXXMMMMXXXXXXXXXXXXXXXXXXXXXXXXXXY
YYYYYYYYYYYYYYYYYYYYYYYYYYYYYYYYYYYYYYYYYXXXXXXXXMMMMXXXXXXXXXXXXXXXXXXXXXXXXXXY
YXXXXXXXXXXXXXXXXXXXXXXXXXXXXXXXXXXXXXXYYXXXXXXXXMMMMXXXXXXXXXXXXXXXXXXXXXXXXXXY
YXMMMMXXXXXXXXXXXXXXXXXXXXXXXXXXXXXXXXXYYXXXXXXXXMMMMXXXXXXXXXXXXXXXXXXXXXXXXXXY
YXMMMMXXXXXXXXXXXXXXXXXXXXXXXXXXXXXXXXXYYXXXXXXXXMMMMXXXXXXXXXXXXXXXXXXXXXXXXXXY
YXMMMMXXXXXXXXXXXXXXXXXXXXXXXXXXXXXXXXXYYXXXXXXXXMMMMXXXXXXXXXXXXXXXXXXXXXXXXXXY
YXXXXXXXXXXXXXXXXXXXXXXXXXXXXXXXXXXXXXXYYXXXXXXXXMMMMXXXXXXXXXXXXXXXXXXXXXXXXXXY
YXXXXXXXXXXXXXXXXXXXXXXXXXXXXXXXXXXXXXXYYXXXXXXXXMMMMXXXXXXXXXXXXXXXXXXXXXXXXXXY
YXXXXXXXXXXXXXXXXXXXXXXMMMMXXXXXXXXXXXXYYXXXXXXXXMMMMXXXXXXXXXXXXXXXXXXXXXXXXXXY
YXXXXXXXXXXXXXXXXXXXXXXMMMMMMMMXXXXXXXXYYXXXXXXXXMMMMXXXXXXXXXXXXXXXXXXXXXXXXXXY
YXXXXXXXXXXXXXXXXXXXXXXMMMMMMMMXXXXXXXXYYXXXXXXXXMMMMXXXXXXXXXXXXXXXXXXXXXXXXXXY
YXXXXXXXXXXXXXXXXXXXXXXMMMMXXXXXXXXXXXXYYXXXXXXXXMMMMXXXXXXXXXXXXXXXXXXXXXXXXXXY
YXXXXXXXXXXXXXXXXXXXXXXXXXXXXXXXXXXXXXXYYXXXXXXXXMMMMXXXXXXXXXXXXXXXXXXXXXXXXXXY