;Mapa hecho por Ian Sanna
;Los elementos en el mapa corresponden de la siguiente manera
;  X: Valle
;  Y: Montaña
;  M: Mar

; Empezando el nivel:
YXXXXXXXXMMMMXXXXXXXXXXXXXXXXXXXXXXXXXXYYXXXXXXXXMMMMXXXXXXXXXXXXXXXXXXXXXXXXXXY
YXXXXXXXXXXXXXXXXXXXXXXXXXXXXXXXXXXXXXXYYXXXXXXXXMMMMXXXXXXXXXXXXXXXXXXXXXXXXXXY
YXXXXXXXXXXXXXXXXXXXXXXXXXXXXXXXXXXXXXXYYXXXXXXXXMMMMXXXXXXXXXXXXXXXXXXXXXXXXXXY
YXXXXXXXXXXXXXXXXXXXXXXXXXXXXXXXXXXXXXXYYXXXXXXXXMMMMXXXXXXXXXXXXXXXXXXXXXXXXXXY
YXXXXXXXXXXXXXXXXXXXXXXXXXXXXXXXXXXXXXXYYXXXXXXXXMMMMXXXXXXXXXXXXXXXXXXXXXXXXXXY
YXXXXXXXXXXXXXXXXXXXXXMMMMXXXXXXXXXXXXXYYXXXXXXXXMMMMXXXXXXXXXXXXXXXXXXXXXXXXXXY
YXXXXXXXXXXXXXXXXXXXXXMMMMXXXXXXXXXXXXXYYXXXXXXXXMMMMXXXXXXXXXXXXXXXXXXXXXXXXXXY
YYYYYXXXXXYYYYYYYYYYYYYYYYYYYYYYYYYYYYYYYXXXXXXXXMMMMXXXXXXXXXXXXXXXXXXXXXXXXXXY
YYYYYXXXXXYYYYYYYYYYYYYYYYYYYYYYYYYYYYYYYXXXXXXXXMMMMXXXXXXXXXXXXXXXXXXXXXXXXXXY
YYYYYXXXXXYYYYYYYYYYYYYYYYYYYYYYYYYYYYYYYXXXXXXXXMMMMXXXXXXXXXXXXXXXXXXXXXXXXXXY
YYYYYXXXXXYYYYYYYYYYYYYYYYYYYYYYYYYYYYYYYXXXXXXXXMMMMXXXXXXXXXXXXXXXXXXXXXXXXXXY
YYYYYXXXXXYYYYYYYYYYYYYYYYYYYYYYYYYYYYYYYXXXXXXXXMMMMXXXXXXXXXXXXXXXXXXXXXXXXXXY
YXXXXXXXXXXXXXXXXXXXXXXXXXXXXXXXXXXXXXXYYXXXXXXXXMMMMXXXXXXXXXXXXXXXXXXXXXXXXXXY
YXMMMMXXXXXXXXXXXXXXXXXXXXXXXXXXXXXXXXXYYXXXXXXXXMMMMXXXXXXXXXXXXXXXXXXXXXXXXXXY
YXMMMMXXXXXXXXXXXXXXXXXXXXXXXXXXXXXXXXXYYXXXXXXMMMMMMMMMXXXXXXXXXXXXXXXXXXXXXXXY
YXMMMMXXXXXXXXXXXXXXXXXXXXXXXXXXXXXXXXXYYXXXXXMMMMMMMMMMMMXXXXXXXXXXXXXXXXXXXXXY
YXXXXXXXXXXXXXXXXXXXXXXXXXXXXXXXXXXXXXXYYXXXXXXXXMMMMXXXXXXXXXXXXXXXXXXXXXXXXXXY
YXXXXXXXXXXXXXXXXXXXXXXXXXXXXXXXXXXXXXXYYXXXXXXXXMMMMXXXXXXXXXXXXXXXXXXXXXXXXXXY
YXXXXXXXXXXXXXXXXXXXXXXMMMMXXXXXXXXXXXXYYXXXXXXXXMMMMXXXXXXXXXXXXXXXXXXXXXXXXXXY
YXXXXXXXXXXXXXXXXXXXXXXMMMMMMMMXXXXXXXXYYXXXXXXXXMMMMXXXXXXXXXXXXXXXXXXXXXXXXXXY
YXXXXXXXXXXXXXXXXXXXXXXMMMMMMMMXXXXXXXXYYXXXXXXXXMMMMXXXXXXXXXXXXXXXXXXXXXXXXXXY
YXXXXXXXXXXXXXXXXXXXXXXMMMMXXXXXXXXXXXXYYXXXXXXXXMMMMXXXXXXXXXXXXXXXXXXXXXXXXXXY
YXXXXXXXXXXXXXXXXXXXXXXXXXXXXXXXXXXXXXXYYXXXXXXXXMMMMXXXXXXXXXXXXXXXXXXXXXXXXXXY
YYYYYYYYYYYYYYYYYYYXXXYYYYYYYYYYYYYYYYYYYXXXXXXXXMMMMXXXXXXXXXXXXXXXXXXXXXXXXXXY
YYYYYYYYYYYYYYYYYYYXXXYYYYYYYYYYYYYYYYYYYXXXXXXXXMMMMXXXXXXXXXXXXXXXXXXXXXXXXXXY
YXXXXXXXXXXXXXXXXXXXXXXXXXXXXXXXXXXXXXXYYXXXXXXXXMMMMXXXXXXXXXXXXXXXXXXXXXXXXXXY
YXMMMMXXXXXXXXXXXXXXXXXXXXXXXXXXXXXXXXXYYMMMMMMMMMMMMMMMMMMMMXXXXXXXXXXXXXXXXXXY
YXMMMMXXXXXXXXXXXXXXXXXXXXXXXXXXXXXXXXXYYMMMMMMMMMMMMMMMMMMMMXXXXXXXXXXXXXXXXXXY
YXMMMMXXXXXXXXXXXXXXXXXXXXXXXXXXXXXXXXXYYMMMMMMMMXXXXMMMMMMMMXXXXXXXXXXXXXXXXXXY
YXXXXXXXXXXXXXXXXXXXXXXXXXXXXXXXXXXXXXXYYXXXXXXXXXXXXXXXXXXXXXXXXXXXXXXXXXXXXXXY
YXXXXXXXXXXXXXXXXXXXXXXXXXXXXXXXXXXXXXXXXXXXXXXXXXXXXXXXXXXXXXXXXXXXXXXXXXXXXXXY
YXXXXXXXXXXXXXXXXXXXXXXMMMMXXXXXXXXXXXXXXXXXXXXXXXXXXXXXXXXXXXXXXXXXXXXXXXXXXXXY
YXXXXXXXXXXXXXXXXXXXXXXMMMMMMMMXXXXXXXXYYXXXXXXXXMMMMXXXXXXXXXXXXXXXXXXXXXXXXXXY
YXXXXXXXXXXXXXXXXXXXXXXMMMMMMMMXXXXXXXXYYXXXXXXXXMMMMXXXXXXXXXXXXXXXXXXXXXXXXXXY
YXXXXXXXXXXXXXXXXXXXXXXMMMMXXXXXXXXXXXXYYXXXXXXXXMMMMXXXXXXXXXXXXXXXXXXXXXXXXXXY
YXXXXXXXXXXXXXXXXXXXXXXXXXXXXXXXXXXXXXXYYXXXXXXXXMMMMXXXXXXXXXXXXXXXXXXXXXXXXXXY