;Map made by Santella Agustin
;element index
;  D : Diert
;  M : Mountain
;  W : Water

; starting the level:
DDDDDDDDDDDDDDDDDDDDDDDDDDDDDDDDDDDDDDDD
DDDWDDDDDDDDDWWWDDDDDFDDDDDFWDFDDDMDDDDD
DDDDDDDDDDMDDDDFDDDDDDDFWWDDDDWFDDDDDDDD
DDDFDFDDDDDDDDDDDDDFDDDFDDDDDDWWWDDIDFDD
DDFDDDDFWWFDDDDDDDDDDDDDDDFDDDDDDDDDWWFD
DDDDDDDDWDDDDDFDDDDDDDDDDDDDMDIFWDDIDDDD
DDDFDDDDWWDFDDWFDDDDWDDDDDFDDDDDWWDDDDDD
DDDDDDDDDDDWDDWWDDDFDDDDDDDDDFDDDWDDDDFD
DDDDDDDDDDDDDDDDWDDDDDDWWFDDDDDDDWDDDDWD
DDDDDDDDDDDDDDDDWWWFDDWDDDDDDDDDWWWDDDDD
DDDDDDDDDFDDDDDDDDIDDDDDDDFWWDDDDDMDDMDD
DDDDDDDDFWWDDDDDDDDDDDDDDDFDDDFWWDDDDDMD
DDDFDDDDDFDDDDDDDDDDDDDDDDDDDDDDDDWDDDDD
DWDDDFDDWWDDDDDWDWWWDDDDDDDDFDDFDDGDDDFD
DWWDDDDDDDDDFDDDDDDDDFDDIDDDDDDWDDDWWFDD
DDDDDDDDDMFDIDDFDMDIFDDDDDDDDDDDDDDDDDDD
DDDDDDDDDDDDDDFWWDDDDDDDDDDWDDDDDDDDDDDD
DDDWFFDDDDDDDDWWDDDDDDDDDDDDDDDWWDDMDDDD
DDDWWWFDGDDWDDDDDDDDWWDFFDDDDDWDDDDDMDDD
DDDDDDDDFDDWWFDDFDDDDDDDDDFDDDDDDWWDDDWD
DDDWWWDWWWFDFDDDDDDDDFDDWDDDDDFDFDDDDDDD
DWDDDDDWWWDDWWDDDDDDDDIFDDDFDFDDDDFDDDDD
DDDDDDDDDDDDDDDDDDDDDDDDDDDDDDDDDDDDDDDD