;Map made by Santella Agustin
;element index
;  D : Diert
;  M : Mountain
;  W : Water

; starting the level:
DDDDDDDDDDDDDDDDDDDDDDDDDDDDDDDDDDDDDDDDDDDDDDDDDDDDDDDDDDDDDDDDDDDDDD
DDWDDDWWDDDDDDDDWWFDDWWDDDWWDDDDDDDFWDDDDDDDDDDDFFWWDDDDDDDDMDWWDFDWDD
DDDDDDDDDDDDDDFWWWWWWDDWFDDWWDDGDDDDWWDDDDDDDDGDDFFDDDWWDDDDDDFDDDDWFD
DDDFDDDWDDDIDDDDDFWFDWWWFDDDDDIDDDDDDIDDDDDWWFDDFWWDDDDDDDDWDDDDDDWWDD
DDDDMDDWWDDDDDDFDDDDDDDDDDFDDDDDDFDDDDDDDWWDDDDDDDFWDDDDDDDDDWDDDMDDDD
DDDDDFWDDDDDDDDWWDDDDDDDDDDDDFDDDDDDDMDDDDDWWFDDDDDDDDDDDDIDDDDDDDIDDD
DDDMDDDDDDDDDFDDDDDDDDDDWWDWWDDFIDIDDDDDDFDDDDDDFDDDIDDDDDDDDDWWFDDDDD
DDDDDWWFFWWFDWDDDDDDMDDDDDWFDDDDDDDDDDWWDDDDDDDWWDDDDDDDDDDDFWDDWDDDDD
DDDDDDWWDDDDDGDDWDDDFDDDDDDDDWWDDDDDDDDDDDDFDWDDDDDDDDDDDDDFWWDWWDDDDD
DDDDWWFWDDFDDDMFWDDDWWFDDDDDDWDDDDDDWWDDDDDDDDFDDDFFDDDDDDDDDDDDDDDDDD
DFDDDDFWWWWDDDDDWDDDDDDDDDDDDDDDDDDDDIDDDDDDDDDFDDWWDDDDFWWFDDWFDIDDDD
DWDDDDFDFWFWWDDDWWDDDIDWDDDDDDWWDDDDDDDDDDDDDDDWDDDDDDDDDDDDDFWDIDDDDD
DDDDDDDDFDDDDDDIDDDFDDDWWDFDDDDDDDDDDDDDDDGDDWWWWDDDDDDDDDDDDDWWFMDDDD
DDDDWWDDDFDDDDDDDDDDDFWWDDWWDDDIDDDDDDDWDDDDDDFDDDDWDFWWFDDDDDDDDDDDID
DDDDDDDDDDDIDDDDDDDDDDGDDDWWDDDDDDDDWDWWDIDDDDDFDDWDDDWWDDMDWWDDDDDIDD
DDIDWFDDIDDDDDWWFDDWWDDMDDDDDDDDDDDFDFDDDDDWDDDDDDDWDDWWWWDDDWWFDDDDWD
DFDDWWDFDFDDDDMDDDDFDMDDWWDDFDDDDDDWDDDFDDDDDDIDMDDDDDDDDDWDDDGDDDDDDD
DWDFWWDDDDDDDDDWDDDDDDDDDDDMDDDFDDDWDDDDDDFDDDDWFDMIFDDDDFDDDDDDDWDDDD
DWWWDDDDFWWWWFDWWDDDDDWWDWWDDDDDDDDWDDDDDFDMDDDDDDFMDDIDDWDDDDDDDWWFDD
DIDDDWWDDDDDWWDDDDDDDDDWDDDDDFDDDDWWFGDDDDDDIDDDDDDDDDFDDWDDDDWDDFDDDD
DDDDDWWDWWDDDDDDFDDDDDFDDDDDDIDDDFDDDDDDWDFDDDDWWWDDDFWDWWDDDFWWDDDDDD
DDWDWWDDDDDDDDDDDDDDDDDDDDDDMDFDDDDDDDDDWDDDDWWWWDDDDDDGFDFDDWDDDDDDDD
DWWFDDDDFDWWDDDDDDDDDDDFDDWDDDWWDDDDDDDDWDDDDWWDDDDDDGFDDDWWDIDDDDDDID
DFDDDDDDDDDDDWWDDDFDDDWDDWWDDDDFWDFDDDWDWWWWFDDDDDDWWDDDDDDDDDDDDDWWDD
DDDDDDDDDDDDDDDDDDDDDDDDFDDFWDDDDFWWWDDDDDDDWWWDDDDWFFDDDDDDDDDDDIFDDD
DDDDDDWWDDWDDDDDDDDDDDDFDDDWWFWWDDFDDDDDMDDIDDDDDDDFWWFDDDDWWDDDDDDDDD
DGDDDFDDDWWDDDMDDDDDDDDDDDDDDFDDDDDDIDDDDDDIDDDDDDDDDDDDDDDGDDDDDDWWWD
DDDMDDFDDWDDFDDDDDDIFDDDDDIDFDDDDDDDDDDDDDDDDDIDDDDDDDDWDDDDWWWDFDDDDD
DDDDDDDDDDDDDDDDDDDDDDDIDDDWFDWDFDDMDDDDDDDDDDDDDDDDDFWWDFDDDFDDWWWDDD
DDWWDDWFDDDDDDDDDIFDFDDDDIDWWDMDWFDIDGDDDDFDDDDDDDDDDDDFWWWDIFDDDDDFDD
DDDDDFDDDDDDDDDDDDFWWDDIDFDDFWFDWDWDDDDDDDWDDDFDDWDDDDDDFDDDDDDDMFWWWD
DDWWDDDDDDDDFDDDDDDDDDDDWWWDDDDWWFWWWWDDDWWDDDWWDIDWDDDDDDDDFDFDFFDDDD
DDFDDDDDDDDDDDDDDDGDDDDDDDDDDDDDFWWDWWWDDDDDDDFDDDDWWWDWDDDDDDDDWWDDDD
DDDDDDDWWDDDDFDDDDDDDDDDDDDDFDDFDFDDDDDFDDDDDDDDDFDDDDFWDDWFDDFDWFDDDD
DGDDDDDDDDDDDWDDDDDDFWDDDDWFWWDDDDDDDFWWDGFDDDFDDWDDFDFWWWDDDDWFDDDDDD
DIDDFWWDFDDDDDDDFDDDFWFDDDWWWDDDDFDDWWDDDDDDDDDDWWDWWWDDFDWWDFIDDDDDDD
DDWWDGDDWWWDDDDDWFWWDDDDDWWDDGFWWWDDDIFDDDDDDDDDDDGDDWWDWFDDWWDWDDWWDD
DDFWDDDDDDDDWWWDDDWWFFDDDDDDDDDDDFDDIDDDDDDFDDDDFDDWWDDWWDDDFDDMGDFDDD
DDDDDDDDDIFDDDDDDWDDDDFDDDDWWFFWWWFDDDDDDDDDDDDWWDFWFDDDDDDDDDDDDDDFDD
DDDDDDDDDDDDDDDDDDDDDDDDDDDDDDDDDDDDDDDDDDDDDDDDDDDDDDDDDDDDDDDDDDDDDD