;Map made by Santella Agustin
;element index
;  D : Diert
;  M : Mountain
;  W : Water

; starting the level:
DDDDDDDDDDDDDDDDDDDDDDDDDDDDDDDDDDDDDDDDDDDDDDDDDDDDDDDDDDDDDDDDDDDDDD
DDDDWDDDDDDWWFDDDDDWDDFDDMDDDDDFDWWDDFFFDDIFDDDDDDFDDDGDDDWDFDDDDDDDDD
DDDDDIDDDDFDDFWWDDDDFWWDFDDDDDFDDWDDDWWFDDDDDDDFDDDDWWDFDWWDDDDDDFDDDD
DDDDDDWDDDFDDDDFDDDDWWFFWWDDDDFDDDDDDDDDDWWDDDDWWDDFDDDWDWDDDDFDDDFDDD
DDDDDWWDFWWDDDDGDDDWDFDDDDDDFWWWDDDFDDDDDDDDDWWDWDDWDDWDDDDDDDDDDDIDDD
DDDDDDDDDDWWDDDDDDFDDGDWDDDDFWDGFDDDDWDWWDDDDDDDWWDDDDDWWDWDDDFWWDDDDD
DDDDDDFWDIFDDDDDDDDDDDWWWDDDDDWDDFDDDWFDDDDDDDDDDDDDDDFDFDWDWDWWDDDFDD
DDDDDDDIDDDDDDDDFWDDDDDFDDDIFDWWDDDDFWWDDDDDDDDDDDDDMDDDDFDDWDDDDDDDDD
DDDDDDDDWDDWWWDDWWDWWDDWWDDDDDWWDDFDFDDDDDIDDDDDDDDDDDDDDDDDDDDDFDDMID
DDDDDDFDDDDDDDDIDDFDDDDDDDDDDWWWDWWWWDWFDDDDDFDGDDDFDDFWDDWWFDIDDDDDDD
DDDDDDDDDFWWDDDFDDWDDDDDDDDDDDDDDMDDDFWDDDDDDDDDDDDDDDWWWWFDDDDDDDDDDD
DDDDDDDDDWWFDDDDDWWWDDDDFDDDDFDDDDDDDDDDDDFDDDDDDDWWWWDDDDDDWFWDDDDDDD
DDDDDDDDDDDDDDDDDIDDDDDDWDDMDDDDWWDWDDDDFDDDDDWWDWWDDDDFDDFWWDWWFDDDWD
DDDIDDDDDDDDDGDDDDDDDDDDWWDFDDDDDDDDDDDWWFMDDDDWDDDDDDDWWFDDDDDFDFDDDD
DGDMDDDWWWWDDDDWDDDDDDDDDDDWWDDDDDDDDDDDDDDDDIFDDWFDDWDDDDDIFDMDFDDDDD
DDGFDDDDFDDWWDWWWWDDDDDDDDDDWWDDDDDDDDDDDWDWDDGDDDDDDWDDDDDDDDDDDDDDDD
DDDDIDWDDFDDDDDIDDDDGDDWWFDDIDDDDDDDFDDFDWDDDWDDDDDDDWDDWWWFDDDDDFIDFD
DDFDDWDDDWDWFDWDFDDDDDDDDDMDDDWWFDDDWWFDDDDDDWWFDDDDWWDWFWDDDDDWWWDFWD
DDIDIDDDDWWFDWWWWDDFWWDDWDDDDDDIDDDDDDDFDDDDDDDDDDDFWDWWDDDDDDWWDDDFWD
DDDDDDDDDDFDDDDDDDDDDDDDWWDFMDDFDDDDDFDWFDFDDWDDWFDDDMDDDDDFWDDDDIFDDD
DDDDIDDWWDDDDFDDDDDWWDDDDDDDDWDDDGDDFWWDDDDDDWFDDDDDDDDDDDDDDDDDDDDDDD
DDDDDDDDDDDDWWDFFWWDDDDDDDDDDDDWWDDDDDDDFDDDDDDDDDDDDWDMFDDIDDDDDDDDFD
DDDDDGDDDDWDDDDDFWDDDFDDDDDDDDDDDDDDDDDDDFDIFDDDDDDFWWWFDDDDDFDGDWWDID
DWWDDDDDDDDFWWDDDDDWWDDDDDFWDDWDDDDDWWDDDGDFDDDDDDDDDDFDDDDWDDDDDDWWDD
DWWDDDDDDDDDDDDFDDDDDFDDDDFWDWWFDDDDDDDDDDDDDFDDDDDDFWWDDDDDFDFDDWWDFD
DDDDDWDDDDDFWWDDDDDDFWFDDWWWDDDDDWFDDDDDWWDDDDDDDDFFDDIDGDDDDFDIDDDDDD
DDDDFDDDDFWFFDDDDDWDDDDDDDDDDDDDDWWDDDDDDDDDFDDDDWWWDDDDDDDFDDDDWDDDDD
DDDDDDDDDDWWFDDDDWWDDDFDFDDDIFDDDDDDDDDDDDIDWFDDDWWDDDDDDDDWWWWDWWDDDD
DFDDDDDIDWWDDGDDDDDDDDDDWDDDDDDDDWWDDDDDDDDWWDDDDDDFDDWFDDDDDDDDIDDDDD
DDDFDDDDDDDWFMDDDDDDDDDDDDDDDDDDDDDDDFDFDDDFDDDDDWWDDWWFWWDDDFDDDDFDDD
DDWDMDDDDFFDDDDDFDDDDWDDDMMDDDFDFDDDDDIFDFDDDDDFWDDDDDDDDDDFWWDDIDDDDD
DDDDDDFDFWFDFDFDDDDDDDFDDDDDDDDDDDDDDDFDDWWFDDDDDDDFDDMDDDDFDDDDDDDDDD
DDDDDFWWDDIDWWWFDDDDDDDFFDDDDDDDDDDDDDDDDDDDDDFDDDDDDDFDDWDWDDDDDIDDDD
DDDDDDDDDDDDDDDFDDDDDGDDDDWDDDDWWDDDDDDDDIDIDDWDDDDDDDDDWDWWDDWDDDDDDD
DDDDDDDDDDWFGDFDFDDFDDDGDWWDDDFDDDWDDWFDDDDDDDWDFFWWDDFDFMDDDDWWWDDWWD
DDDDDDDDDFDDDDDDDDWWDDDDGDDDDFIDDFDDDDDDDDFWWDDDDFWDDDDDWDDWDDDDDDDFDD
DDDWDDIDDDDFWDDDDFDDDDMDDDDDDDDDDDFDDDFWDDDDDDDIDDDDDDDDDDDWWFDDDDDIDD
DDDDDDDDWWWDDDDFDDDDIFIFDDDDDDDMDDDDDGDMDDGDDDDDDDDDDDDDDDDFDDDIDFDDDD
DDWDWDIDDWWDDDDDFWWWDDDDDMFWFDDDWDDDDDDDDDDDDDFWDDDDDMDDDDFMDDDDDDFDDD
DDDDDDDDDDDDDDDDDDDDDDDDDDDDDDDDDDDDDDDDDDDDDDDDDDDDDDDDDDDDDDDDDDDDDD