;Map made by Santella Agustin
;element index
;  D : Diert
;  M : Mountain
;  W : Water

; starting the level:
BBBBBBBBBBBBBBBBBBBBBBBBBBBBBBBBBBBBBBBB
BWWWDMDDDDDDDDDWWWDDDDDDDDDDDDDDDWWWDDDB
BWWDDDDDDDDDDDDDDDDDDWDDMDDDDDDDWDDDDDDB
BDDDDDDDDDWDMDDDDDDWWWDDDDWWWDMDDDDDDDWB
BDWWDDDWDWWDDDWWDDWWDDDDDDDDDDDDDDDWDDDB
BWDDDDWWDDDMDDDDDDDDDDDDDDDDDDDDMDDWWDWB
BWWDDDDDDDDDWWDWDDDDDWDDWDDDDDDDDDDDDWWB
BDDDDDDDDDDWWDDDDDDDDWDDDWWWDWWWDWWDWDDB
BDDDWDWWDDWDDDDDDDDDDDDDWDDDWWWWDDDWWDDB
BDDDDWDDDDWWWWDDDDDDWDDDDWWWDDDDDDDWWWDB
BDDDWWDDDWDDDDDWWDDDDWDDWWDDWDDDDWWWDDDB
BWWDDMDDWWWWWDDDDDDDDDDDDDDDDDDDDDDDWWDB
BWDDDDDDDMDDDDDDDDDDDDDDDDDDWWDWDDDWDDDB
BWWDDWDDDDDWWWDDDWDDDDWWDMDDDDDDDDDDDDWB
BDDDWDDWWDDDDDDDDDDDDDWDDDDDDDMDDDDDDDDB
BDDDDWDDDDDDDDDDDDDWWWDWWDDDDDDDDDDDDDDB
BDDDDDDDDDDDDWWDDDDDDDWDDMDDDDDDDDWDDDDB
BWWDDDDDDDDWDMDDDWDMDDDDDDDDDMDDDDWWDDDB
BWWDDDDDDDDDDDDDDMDDDDDDDDWWDDDDDMDDDDDB
BDDDDDDDWDDDDDDDDDDDDWWDDWDDMDDDDDDDDDDB
BDDWWDDDDDDDDDDMDDDDDDWWWWDDDDDDDDDDWWDB
BDDDDDDDDDDDDDWDDMDDDDDDDDWDDDDDDDDDDDDB
BBBBBBBBBBBBBBBBBBBBBBBBBBBBBBBBBBBBBBBB