;Mapa hecho por Ian Sanna
;Los elementos en el mapa corresponden de la siguiente manera
;  X: Valle
;  Y: Montaña
;  M: Mar

; Empezando el nivel:
BBBBBBBBBBBBBBBBBBBBBBBBBBBBBBBBBBBBBBBBBBBBBBBBBBBBBBBBBBBBBBBBBBBBBB
BDWDDDDDDDDDDDDDDWDDDDDDDDDDWDDDWWDDDDDDDDMDDDDMDWWWDDDDDDDDDDDDDWWWWB
BDDDDDDDDDDDDDDDWWWDDDDDWDMDWWDDDDWWDDDDDDDDDDDDDDMWDDDDDDDDDWDDWWWDWB
BWDWWWDDDDDDDDDDDDWWDDDWWDDDDDDDDDDDWWWWDDMDDDDDDDDWWDDDDDDMDWWWDWWWWB
BDDDDDDDWDDDDDDDDDDDDWWDDDDDWWWWDDDDDDDDDDDWDDDDDDDWDDDDDWWDWWDMDDDDDB
BWDDDDWWWWWWWDDDWDDDDDWDMDDDDDDDDDDDDDDWDDDDMDWDMDDDDDDDMDDDDDWDWDDDDB
BDDDDDDDWWWWWWDDDDDDDDWDDDDDDDDDWWWDWDWWDDDMDDDDDWWDDWDWDDDDDDWDWWWDDB
BDDDDDDMDDWWWDDDDDDDDDDDDDDMDDDWWDDDMDDWWWDDDDDWDDDDDDDDDDDDDDMDDDDDDB
BWDDDWWDDDDDMDWWWWDMDWDWDDDDWWDWDDDDDDDDDDMDDWDDDDWDDDWDDDDDDDDMDDDDDB
BWWDWDDDDWWDDDDDDDDDWWDWWWDMDDDWWWWDWWDWWDDDWWWDWWWDDDWDWDDWWDDDDDDDDB
BWDDWWWWDDDDDDDMDDDDWDWDDDDDDMDDWWDDWDDDDDDDDDDDDDDDDDWWWDWDWWDDMDDDDB
BDDWDDWDDDDDWWWDDDDDWDWDDDDDDDDDDDWWWDDWWDDDDDDDWDDWWDWDDWWWWWWDDDDDMB
BDDDDDDDDWDWDDDDDDDDWWWDDDDDDDDWDDDDMDDWWDDDDDWDWDDWDDDDDWWDDDWDDDDDMB
BDDDDDDDWWDWWDDDWDDDDDWDDDDDDDWWWWWWDDDWWWDMDDWWWDDWWDMDDDDDDDDDDDWDDB
BWDWWDWWWDDWDDDDDDDMDDWDDDDDDDDDDDDWWDDDWDDDDMDDDMDDDWDDDDDDDDDDDDWWDB
BDWDWDDDWDWWDDDDDDDDDDMDDDDDMDDDDDDDDWDDDDDDWDDDDDDDWWWDWWDDDDWWDDDDDB
BDDDDDDDDDWDDWDDDDDDDMDWWDDWDDWWDWDDDWWDDDDDWDMDDDWWWDDDDDDDWDDWWDDDDB
BDDDDDWWDWWDWWWWWWDDDDWDDDDDDDDDDWDDDDDMDDDWWDDWWDWWDWWWWWDDWDDDDDDDDB
BWWDDDDDDWWWDDDDDDDDDDWWWDDDDDDDDWWDDDDDDDWWWDDDDDDDWWWWDWWDDDDDMDDDDB
BWWDDWWDWDDDWDDDDDWWDDDDDDDDDDDDDDDDDDDWWDWWDDDWDWWDWDDDWWDDDDDDDMDDDB
BWDWWWDWWDDWWDDDDDWWWDDDDDDDDDDDDDDDDDMDDDWDDDWWDMDWWDDDWDDDDDDDDDDDDB
BDWWDDDDDMDDDWDDWWDDDDDDDDDDDWWWWWDDDDDDDDDDDDWWDDDDMDMDDDWDDDDDWWDDDB
BDDDDDDDDDDWWWWDMDDMDDMDDDDWDDDDWDWDDDDDDDDDDDMDDDDDDDDDDDDMDDDDWDDDDB
BWWDDDDDWDWDWWDDDDWDDDDWWWDDDDDDWDWWDWWDDMDDDDDDDDDDDDDDDDDDMDWDMDDDDB
BDDDDDDWWDDDDDDDDWWWWDDWWWWDDDDWWDDDMDDDDDDDDDDDDDDDDDDDDDDDDDWWDDWDDB
BDDDDDDDDDDWWWWDDMDDDDDDWWDDMDDDWWWDDDDDDDDDWWDDDDDDDMDDMDDDDDDDDDDDWB
BDDDDDDDWDDDWWWWWDDWWWDDWWDDDWWDDDDDWWDDDMDMDDDDDDDWWDDDDDDDDWWDDDDWWB
BWDDDDDDDDWDDDMDDDDDWDDWDDDDDDWWDDDDDDDDDDDDDDWWDDDWDDDDDDDWDDMDDDDWDB
BWWDWDDDDWWWWWDDMDDDDDDDMDDDDDWWWWDDDDMDDDMDDDDDDDDWDMDDDDWWDDDDWWDWWB
BDWDDDDDDDDDMDDDDDDWDDDDDDDDDWWDDDMDDDDDWWDDWDDDDDDWDDDDDDDDDDDWDDDDDB
BDDDDDWDDDDDDDWDDWWWWWWWDMDDDDDDDDDDDDDDDMDDWDDDDDDDDWDDDDDDDWWWWDMDDB
BWDMDWWDDDWDDDDDDDMDWDWWDDWWDDDDDDDDDDDDDDWWWDWDDMDDDWWWWWWDWWDDDMDDDB
BDDDDDWWWWWDDDDWWDDDDDMDDDDDWWWWWWWDDDDDDWWWDDDDWDDDDDWDDDDDDDDDDDDMDB
BDDDMDDDDDDDDDDDDDDDDWDDDWDDDWWDDDDDDWDDDDDDWWDWWDDDDWWDDDDDDDDDDDWDDB
BDDWDDDWDDDDWWDWWWDDDWWWDDDDDDDDDDDDDWWDDDDDDDWDDDDMDDMDDDDDDMDDMDWDWB
BDDWDWWWDDDWDDDDDDDDDWDDDDDDDDDDDWWDDMDWWDDDDDWWWDDDMDDDDDDDDDWDDDWDDB
BDDWDWDDDDDWWDDDDDDDDWDDDDDDDWWDDDDDDDDMDDDDDDDDDDMDDWWDDDDWWDDDDWWWDB
BDDDDWDDWWDDDDDDDDDDDWDWDDDWDDDDDDDDDDDDWWWDDWDMDDDMDDDDDWDWDDDDDDDDDB
BDWDWWWDDDDDDMDDDDDDWWDWDDDDDDDDDDDDDDDWWDWDDWDDDDDDWWDDWWWWDDMDDDDWDB
BBBBBBBBBBBBBBBBBBBBBBBBBBBBBBBBBBBBBBBBBBBBBBBBBBBBBBBBBBBBBBBBBBBBBB