;Map made by Santella Agustin
;element index
;  D : Diert
;  M : Mountain
;  W : Water

; starting the level:
BBBBBBBBBBBBBBBBBBBBBBBBBBBBBBBBBBBBBBBBBBBBBBBBBBBBBBBBBBBBBBBBBBBBBB
BDDDDMDDWWWDMDDDDDDWWWDDWWDWDDWDWWDDDDDWDWDDDDDWDDDDDDDDWWDDWDDDDDDDDB
BDDDDDDMWDWWDDMDWDDMDDDDWWDWWWWDDDWWWDDWWWWDDDWWDDDDWWDDDDDWWDDDDDDDDB
BDDDDDMDDDDDWWDWWDDDDDDDDDWDDDDDDWWDDDDDDDWDDDDMDDWDDWWDDDMDDDWWWDDDDB
BDWDWWWWDDDDDDDDDDMDDDWWWDDDDDWDDDDMDDDDDDWWDDWDDDMDDDDDDDDDDWWDDDWDDB
BDWDDWWDWWDDDDDDDWDDDWDDDDDDDWWDDDDDDDDDWWDDDWWDDDDDDWWDDDMDDDDMDWWDDB
BDWWDWDWWDDDDDDWWWWDWWWDDDDDDDDDWWDDDDDDDDDDDWWDDDMDDDWWWDDDDDDDMDDDDB
BDDWDDDDDDDDDDDWDWWDDDDWWDDDDDDDDDDDDDDWDMDDMDMDDDDDDDDDDWWDDWWDDDDMDB
BDDMDDDDDDDDDDDWDDDDDDDMDDDWDDDDDDDDDDDDDDDWDDDDWWDDDDDDMDMDDWWDMDDDDB
BDDDDDDDDDMDWWWWWDDDDDDDDDDWDDDDWWWWDDDDWWDDDDDDDMDWWWDDDDDWWWWDDDDWDB
BDDDWWDDDDDDWDMDDDDDDDDDDWDWWDWWDDDDDDDDDDDDDDDDDDDDDMDDDDDWDDWWDMDDDB
BWWDDDDDDDWWWDDWDWDDDDDDWWWWDDDDDDDDDDDDDDDDDDDDDDDDDDDDDDWWWDWWDDDDWB
BDDDDDDDDDDDDDDDDDDDDDDDDDDMDWDDWWDDMDWWDDDMDDDDWDDDDWDDDWDDDDDDDDDDWB
BDDDWDDDDDDDDDWDDDDDDDDDDDDDWWWWDDDDDDWDDDMDDDDWWDDDDDDDDWWDDDWDDDDWWB
BDWDWWDDDDDDWWWWDWWDDDDDDMDDDDDDDDWWWDDDDDDWWDDDDDWWWDDDDDDDDWWDWDDWWB
BDDDWDDDWWWDDDDDDDWDDDDMDDDDDDWWDWWDDDDDMDDWDDDDDDWWDDDDDWDDWWDDDDDDDB
BDDWWDDDDWWDWDDDDWWDDDDDDDDDDDDDDDDDDDDMDDDDDDWDDDDDDDDDDWWDDDDDDMDDDB
BDWWWDWWWWWWWDDDDDDDWDDDDDDDDDDDDDWWDDDDDWDDDDDDDMDWDDDDDDDDWDDWWDDDDB
BDDDDDDWDDDWDDDWWDDDDDWDDDDDDWWWDDWWDDWWDDDDDDDWWDWWWDDDDDDWWDDWWDWWWB
BWWDDDDDDDDDDDDDDDDDDDDDDDDDDWDDDDDDDWDDDDDDDDMWWWWDWDDWWDDDDWDDDDDDDB
BDDDWDWDDDWDDDDMDDDDDDDDWDDDDWDDDMDDWWDWWDDDDDDWWWDDDDDDDDDDDMDMDDDDWB
BDDDDDWWDDDDDWWDDDDDDDDDWWWDWWDDWDDWWDDDWWDDWDWWDDDDDWWWDDDDDDDDDWDDMB
BDDDDWWDDDDDWWDDDDDDDDWWWDDDWWWDMDWWDDDDWWWDDDDDDDDDDDWWWWDDWDWWDDDDDB
BWWDDDWDDDDDDDDDDDDDDWWDWWDDDDDDDDWDDDDWWDDDDDDDDDDWDDWWWWDDWDDDDDDDDB
BWDDDDDDDWDDDDDDDWWDDDDWWWDWWWDDWWWDDMDWDDDDDDWDDDWWDDDWDDDDWWDDWDWDDB
BDDDDDDDDWWDDDDDWWWDDDDDWWWWWWDDDDDDDDDDDDDWWDWWWDDWWDWWDDDDDDDDDDWWDB
BDDDDWWDDDDDWWWDDDDDDDDDDDDDDDWWDDWWDDDDDDDWWDDDDDDDDDWDDDDDDDDDDDDDWB
BDDDWWWDDDDDDDWWWWDDDDWWDMDDDDDDMDDDDDDDDDDDWWDDDMDDWWWDDDDDDDDDDDDWDB
BDDDDWDDDWWDDDDMDDDDDDWWDDDDDDDDDDWDDWWDDDDDDDDDDDWDDDMDDDWWDWWDDDWWDB
BWWDWWDDDDDDDDDDDDWWDDDWWWDDDDDDDDWWWWDDDDDDDDDDMDWDDDDDDDDDDWDDDDWWDB
BWWDDDDDDDMDDMDDDDDDDWDMDMDDDDDDWDDMDDDWWWDDDDDDDWWDWDDDDDDDDWDDDDDDDB
BDDMDDDDDDDWDDDDDDDDDWWDMDMDDDDWWDDDDDDDWDDDDDDWDDDDDDDDWDDDDWWDDMDDDB
BDWWDDDDDDDWWDDDMDDDWWDDDDDDDDDMDDDWWDDDWWDMDWWWDMDDDDWWWDDDDDWWDDDDDB
BWWWDDDDDDDWDMDDDWWDDWWWDDDDDDMDDDMDWDWWDDDDDWDDDDDDDDDDDDDDMDDDDDWWDB
BDDDDWDDDDDWWDWWDDDDDDDDDMDDDDDDDDDDWWWDDDWDDWWWDDDDDDDDDDWWDWDDMDDDDB
BDDDWWDDDDDWWDDDDDDDDMDDDDDDDDDDDMDWDDDDDDWWWDWDDDDWDDDDWWWDWWWDDWWDDB
BDDDDDDDWDDDDDDDDDWWDDDDDDDDMDWDMDDWWDDDDWDDDDWWWDDDDDDWWDDDWWDDDWWDDB
BDWWDDDDWWDWDDDDDDDWDDWDDMDDMDWWDDDDDDDDWWWDDDDMDWDDWWDDDDDDDDDDMDWWDB
BDDDDDDWWWDMDDDDDDDDDWWDDDDMDDWWDDDDDDDDWDDWWDDDDDDDWDDDDDDDDDWDDWWWDB
BBBBBBBBBBBBBBBBBBBBBBBBBBBBBBBBBBBBBBBBBBBBBBBBBBBBBBBBBBBBBBBBBBBBBB