;Map made by Santella Agustin
;element index
;  D : Diert
;  M : Mountain
;  W : Water

; starting the level:
BBBBBBBBBBBBBBBBBBBBBBBBBBBBBBBBBBBBBBBBBBBBBBBBBBBBBBBBBBBBBBBBBBBBBB
BDDDDDDMDDDDDDDDDDDDDDDDDDDWDDDDDDWWDDWDDWWWWDDDDDDDDDDDDDDDDWWWWWDDDB
BDWDDDDDDDMDDDWWDDWDWWWDDDDDDDDDDDDDMDDWDDDDDDDDDDWWDWWDDDDDMDDDDDWDDB
BWDWDDDDDDDDDDDDDDDDDDDDDDWWWDDDDWWDDDDDWDDDDDDDWWDDWWDWDDDDDWWDDDDDDB
BWDWWDDDDDWWDWWDDDDDDWDDDDDDDDDDDMDWDDDDDDDDMDDDDDDDDDWWWDDDDDDWDDDDDB
BDWDDDDDDDDWDDDDWDDDWWWDDDDDDDDDDDDWDDDDDDDDMDDDMDDWDWDDDDDWWWWDMDDDMB
BDWDDDDDWDDWWDDDDWWWDDDDDDDDMDDDDDDDDDWWDDDDDWWWDDDDWDWWWDDDDDWWDDDDDB
BWDWDDDDDDDDDWDWWDDDDDWDDDDDDWDDDDDDDDDDDDDDDDDWDDDDDDDDDDDDDDDDDWDDDB
BDDWWDDDWDDDWDDWWDDDDDDDDDDDDWDWDWWDDDDDWDWDDDDDWDDDDDWDWDDDDDDDDWWDDB
BDDDDDDDMDDWWWDDDDDDWWWDDDDDDDWWWDWDDDDDWDDDDDDDDWDDDDDDDDDWWWWDDDDDWB
BWDDDDDMDDDDDDDDWDDWWDDDDDWDDDMDWDDDDDDDDDDDDDDWDWWDDDDDDDDDDDWWDDDDDB
BWDDDDDDDDDDDDDWWDDDDDDDDWWDWDDDDDDDDDWDWDDDDDDWWDDDDDWDDDWDDWDDDDDDWB
BDDWDDDWWDDDDDDDDWDDDWDDDDDWWDMDDDDDDDDWWDMDDDDDWDDDDWWDDDWWDDDDDDDDDB
BWDWDDDDDDDDDDDDDWWWWWDDWDWDDDMDDWDWDDDDDDDDDDDDDDDDDDDDWWDDWWDDDDDDDB
BDDDDDDDDDDDWWDDDDDDDWWWWDDDDDDDDDWWWDDDDDDDDDWWDDMDDWDDDDWWDDDWDDDDDB
BWWDDDDDWDDDDWDDDDDDDDDDDDDDDDDDWWDDDDDMDDDWDWDDWDDDDDDDDDDDDDDDDDDDDB
BDDDDDDDDMDDDDDDWWDDDDDWWDDDDDDDDMDDDDWDDDDDDDWWWDDDWDDWWDDDDDDDDDDDDB
BWDDDDDDWDDDWDDDMDWWDDDDDDDWWDWWWDDWWDDDDDWWDDDDDDDWWDWDDDDDDDMDDDDDDB
BDDDDWDDWDDWWWWDDDDWWDDDDDDDDWWWDDDDDDDDDDDMDDDDWDDDDWDDDDDWDDDDDDWDDB
BDDDDDDDDWDDDDDDDDWWWDDDDDDWDDDDDDDDDDDDDDDDDDWDWWDDWDWDDDDDDDDDDDDDWB
BDDDDDDDWDDWDWDDDDDDDDDDDDDDWDDDDDDDDDDWWDDDDDDWDDDDDDWWDDDDMDWWDDDDMB
BDDMDWWWWWDMDDDDDDDDDDDDDWWDWDDDDDDDDWDDDMDDDDDDDDDDDDDDDDDDDWWDDDWDDB
BDDDDDWDDWDDWDDDDWDDMDDDDDDDDWWDDDDDMDWWDDDDDDDDWWDDDDDDDDDWDDDDDWWDDB
BDDDDWWDWDDDDDDDWWWDDDWDWDDDDWWDDDDDDDDDDDDDDDDDDDDDDDDDDDWWWDDDDDDDDB
BDDDDDDDDWDDDDWDDDWDDDDDDDDWWWDDDDDDDDDDWDDDDDDDDDWWWDDWDDDDDDDDDDDDDB
BDDDDDDDWWWWDWWDDDDDDDMDDDDMDDWDDDMDDDDDWDDDDDDDDDDWDDDDWDDDDDDDWWDWWB
BDDWDDWWWDDDWDDWDDDDDDDDDDDDWWWWDDDWWDDDDMDDDWDDDDDDDDWWDWDDDDDDDDDMDB
BDDDDDDMDWWWWDDDWDDDDDDDMDDDDDDDWWDDDDDDDDDDWWDMDDDDDDDDWWDDDWWWDDDMDB
BDDDDDDDDDWDDDDWWDDDDDDDDWDDDDWDDDWDDDDDDDWWDDDDDWWDDDDDDDDDDDDDWWDDDB
BDDDDDDDDDDDDDWWDDDWDDWDDWWDDDDDDDDDDDDDDWDDWDDDWWDDDWDDDDDDDDDWWWWWDB
BDDDWWWDDDDDDDWWDDDDWDDDDDWWDWDDDDDDDDDWDWWDDDDDDDDWWWWWDDDDDDDDDWDDDB
BDDDDWDWDDDDDDDDDWDDDWWDWDDWDDDDWDDDDDDDWDDDDDDDDWDDDDDDDWWDDDDDDDDDDB
BDDDDDWWWWDDDDMDDDDWWDDDDMDDDDMDDDDDWDDWDDWDDDDDWDDDDDWWDDDDDDDDDDDDDB
BWDWWWDMDDWDDDDDDDDWWWDDDDDDDDDDWWDDDDDDDDDWDDDDDWDDDDDDDDDDDDWDDDDDDB
BDMDDDDDDDWWWWDDDDDDDDDWDDDWWDDDDDWWDWWDDDDDWDWWWWWDDDDDMDDDWWWWDDWDWB
BWDDDDDWWWDDDDDDDWDWWDDDDDWDDDWWDDDDDDDDDDDDDWWDDDDDDDDWDDDDDDMDDDWWDB
BWDDDDDDDDWWDDDMDWWWDDDDDWDWDMDDDDDDDDDDDDDWDDDDDDDDDWDWWDMDDDDWWWWDWB
BDDDDDDDDDDDDWWDDWWDDDMDDDDDDDDDDDDWWDDDDWDDDDMDDWWWDDDDDDDWDDDDDDDDDB
BDDDWDDMDDDDDDDDDDWWWDDDDDDDDDDWDDDDDDDDWWDDWDDDWWDDDWWDDDWDDWDDDWWWDB
BBBBBBBBBBBBBBBBBBBBBBBBBBBBBBBBBBBBBBBBBBBBBBBBBBBBBBBBBBBBBBBBBBBBBB